ID,LIMIT_BAL,SEX,EDUCATION,MARRIAGE,AGE,PAY_0,PAY_2,PAY_3,PAY_4,PAY_5,PAY_6,BILL_AMT1,BILL_AMT2,BILL_AMT3,BILL_AMT4,BILL_AMT5,BILL_AMT6,PAY_AMT1,PAY_AMT2,PAY_AMT3,PAY_AMT4,PAY_AMT5,PAY_AMT6,default payment_next_month,diff_paid1,diff_paid2,diff_paid3,diff_paid4,diff_paid5,diff_paid6,sum_bill_amount,sum_payment_delay,sum_payment_amount,%_sum_bill_in_limit
1,20000,2,2,1,24,2,2,-1,-1,-2,-2,3913,3102,689,0,0,0,0,689,0,0,0,0,1,3913,2413,689,0,0,0,7704,-2,689,38.519999999999996
2,120000,2,2,2,26,-1,2,0,0,0,2,2682,1725,2682,3272,3455,3261,0,1000,1000,1000,0,2000,1,2682,725,1682,2272,3455,1261,17077,3,5000,14.230833333333335
3,90000,2,2,2,34,0,0,0,0,0,0,29239,14027,13559,14331,14948,15549,1518,1500,1000,1000,1000,5000,0,27721,12527,12559,13331,13948,10549,101653,0,11018,112.94777777777779
4,50000,2,2,1,37,0,0,0,0,0,0,46990,48233,49291,28314,28959,29547,2000,2019,1200,1100,1069,1000,0,44990,46214,48091,27214,27890,28547,231334,0,8388,462.668
5,50000,1,2,1,57,-1,0,-1,0,0,0,8617,5670,35835,20940,19146,19131,2000,36681,10000,9000,689,679,0,6617,-31011,25835,11940,18457,18452,109339,-2,59049,218.67800000000003
6,50000,1,1,2,37,0,0,0,0,0,0,64400,57069,57608,19394,19619,20024,2500,1815,657,1000,1000,800,0,61900,55254,56951,18394,18619,19224,238114,0,7772,476.22799999999995
7,500000,1,1,2,29,0,0,0,0,0,0,367965,412023,445007,542653,483003,473944,55000,40000,38000,20239,13750,13770,0,312965,372023,407007,522414,469253,460174,2724595,0,180759,544.919
8,100000,2,2,2,23,0,-1,-1,0,0,-1,11876,380,601,221,-159,567,380,601,0,581,1687,1542,0,11496,-221,601,-360,-1846,-975,13486,-3,4791,13.486
9,140000,2,3,1,28,0,0,2,0,0,0,11285,14096,12108,12211,11793,3719,3329,0,432,1000,1000,1000,0,7956,14096,11676,11211,10793,2719,65212,2,6761,46.58
10,20000,1,3,2,35,-2,-2,-2,-2,-1,-1,0,0,0,0,13007,13912,0,0,0,13007,1122,0,0,0,0,0,-13007,11885,13912,26919,-10,14129,134.595
11,200000,2,3,2,34,0,0,2,0,0,-1,11073,9787,5535,2513,1828,3731,2306,12,50,300,3738,66,0,8767,9775,5485,2213,-1910,3665,34467,1,6472,17.2335
12,260000,2,1,2,51,-1,-1,-1,-1,-1,2,12261,21670,9966,8517,22287,13668,21818,9966,8583,22301,0,3640,0,-9557,11704,1383,-13784,22287,10028,88369,-3,66308,33.98807692307692
13,630000,2,2,2,41,-1,0,-1,-1,-1,-1,12137,6500,6500,6500,6500,2870,1000,6500,6500,6500,2870,0,0,11137,0,0,0,3630,2870,41007,-5,23370,6.509047619047618
14,70000,1,2,2,30,1,2,2,0,0,2,65802,67369,65701,66782,36137,36894,3200,0,3000,3000,1500,0,1,62602,67369,62701,63782,34637,36894,338685,7,10700,483.83571428571435
15,250000,1,1,2,29,0,0,0,0,0,0,70887,67060,63561,59696,56875,55512,3000,3000,3000,3000,3000,3000,0,67887,64060,60561,56696,53875,52512,373591,0,18000,149.4364
16,50000,2,3,3,23,1,2,0,0,0,0,50614,29173,28116,28771,29531,30211,0,1500,1100,1200,1300,1100,0,50614,27673,27016,27571,28231,29111,196416,3,6200,392.832
17,20000,1,1,2,24,0,0,2,2,2,2,15376,18010,17428,18338,17905,19104,3200,0,1500,0,1650,0,1,12176,18010,15928,18338,16255,19104,106161,8,6350,530.805
18,320000,1,1,1,49,0,0,0,-1,-1,-1,253286,246536,194663,70074,5856,195599,10358,10000,75940,20000,195599,50000,0,242928,236536,118723,50074,-189743,145599,966014,-3,361897,301.879375
19,360000,2,1,1,49,1,-2,-2,-2,-2,-2,0,0,0,0,0,0,0,0,0,0,0,0,0,0,0,0,0,0,0,0,-9,0,0.0
20,180000,2,1,2,29,1,-2,-2,-2,-2,-2,0,0,0,0,0,0,0,0,0,0,0,0,0,0,0,0,0,0,0,0,-9,0,0.0
21,130000,2,3,2,39,0,0,0,0,0,-1,38358,27688,24489,20616,11802,930,3000,1537,1000,2000,930,33764,0,35358,26151,23489,18616,10872,-32834,123883,-1,42231,95.29461538461538
22,120000,2,2,1,39,-1,-1,-1,-1,-1,-1,316,316,316,0,632,316,316,316,0,632,316,0,1,0,0,316,-632,316,316,1896,-6,1580,1.58
23,70000,2,2,2,26,2,0,0,2,2,2,41087,42445,45020,44006,46905,46012,2007,3582,0,3601,0,1820,1,39080,38863,45020,40405,46905,44192,265475,8,11010,379.25
24,450000,2,1,1,40,-2,-2,-2,-2,-2,-2,5512,19420,1473,560,0,0,19428,1473,560,0,0,1128,1,-13916,17947,913,560,0,-1128,26965,-12,22589,5.992222222222223
25,90000,1,1,2,23,0,0,0,-1,0,0,4744,7070,0,5398,6360,8292,5757,0,5398,1200,2045,2000,0,-1013,7070,-5398,4198,4315,6292,31864,-1,16400,35.404444444444444
26,50000,1,3,2,23,0,0,0,0,0,0,47620,41810,36023,28967,29829,30046,1973,1426,1001,1432,1062,997,0,45647,40384,35022,27535,28767,29049,214295,0,7891,428.59
27,60000,1,1,2,27,1,-2,-1,-1,-1,-1,-109,-425,259,-57,127,-189,0,1000,0,500,0,1000,1,-109,-1425,259,-557,127,-1189,-394,-5,2500,-0.6566666666666667
28,50000,2,3,2,30,0,0,0,0,0,0,22541,16138,17163,17878,18931,19617,1300,1300,1000,1500,1000,1012,0,21241,14838,16163,16378,17931,18605,112268,0,7112,224.53599999999997
29,50000,2,3,1,47,-1,-1,-1,-1,-1,-1,650,3415,3416,2040,30430,257,3415,3421,2044,30430,257,0,0,-2765,-6,1372,-28390,30173,257,40208,-6,39567,80.416
30,50000,1,1,2,26,0,0,0,0,0,0,15329,16575,17496,17907,18375,11400,1500,1500,1000,1000,1600,0,0,13829,15075,16496,16907,16775,11400,97082,0,6600,194.16400000000002
31,230000,2,1,2,27,-1,-1,-1,-1,-1,-1,16646,17265,13266,15339,14307,36923,17270,13281,15339,14307,37292,0,0,-624,3984,-2073,1032,-22985,36923,113746,-6,97489,49.45478260869565
32,50000,1,2,2,33,2,0,0,0,0,0,30518,29618,22102,22734,23217,23680,1718,1500,1000,1000,1000,716,1,28800,28118,21102,21734,22217,22964,151869,2,6934,303.738
33,100000,1,1,2,32,0,0,0,0,0,0,93036,84071,82880,80958,78703,75589,3023,3511,3302,3204,3200,2504,0,90013,80560,79578,77754,75503,73085,495237,0,18744,495.237
34,500000,2,2,1,54,-2,-2,-2,-2,-2,-2,10929,4152,22722,7521,71439,8981,4152,22827,7521,71439,981,51582,0,6777,-18675,15201,-63918,70458,-42601,125744,-12,158502,25.148799999999998
35,500000,1,1,1,58,-2,-2,-2,-2,-2,-2,13709,5006,31130,3180,0,5293,5006,31178,3180,0,5293,768,0,8703,-26172,27950,3180,-5293,4525,58318,-12,45425,11.6636
36,160000,1,1,2,30,-1,-1,-2,-2,-2,-1,30265,-131,-527,-923,-1488,-1884,131,396,396,565,792,0,0,30134,-527,-923,-1488,-2280,-1884,25312,-9,2280,15.82
37,280000,1,2,1,40,0,0,0,0,0,0,186503,181328,180422,170410,173901,177413,8026,8060,6300,6400,6400,6737,0,178477,173268,174122,164010,167501,170676,1069977,0,41923,382.13464285714286
38,60000,2,2,2,22,0,0,0,0,0,-1,15054,9806,11068,6026,-28335,18660,1500,1518,2043,0,47671,617,0,13554,8288,9025,6026,-76006,18043,32279,-1,53349,53.79833333333334
39,50000,1,1,2,25,1,-1,-1,-2,-2,-2,0,780,0,0,0,0,780,0,0,0,0,0,1,-780,780,0,0,0,0,780,-7,780,1.5599999999999998
40,280000,1,1,2,31,-1,-1,2,-1,0,-1,498,9075,4641,9976,17976,9477,9075,0,9976,8000,9525,781,0,-8577,9075,-5335,1976,8451,8696,51643,-2,37357,18.44392857142857
41,360000,1,1,2,33,0,0,0,0,0,0,218668,221296,206895,628699,195969,179224,10000,7000,6000,188840,28000,4000,0,208668,214296,200895,439859,167969,175224,1650751,0,243840,458.5419444444445
42,70000,2,1,2,25,0,0,0,0,0,0,67521,66999,63949,63699,64718,65970,3000,4500,4042,2500,2800,2500,0,64521,62499,59907,61199,61918,63470,392856,0,19342,561.2228571428572
43,10000,1,2,2,22,0,0,0,0,0,0,1877,3184,6003,3576,3670,4451,1500,2927,1000,300,1000,500,0,377,257,5003,3276,2670,3951,22761,0,7227,227.61
44,140000,2,2,1,37,0,0,0,0,0,0,59504,61544,62925,64280,67079,69802,3000,3000,3000,4000,4000,3000,0,56504,58544,59925,60280,63079,66802,385134,0,20000,275.0957142857143
45,40000,2,1,2,30,0,0,0,2,0,0,18927,21295,25921,25209,26636,29197,3000,5000,0,2000,3000,0,0,15927,16295,25921,23209,23636,29197,147185,2,13000,367.96250000000003
46,210000,1,1,2,29,-2,-2,-2,-2,-2,-2,0,0,0,0,0,0,0,0,0,0,0,0,1,0,0,0,0,0,0,0,-12,0,0.0
47,20000,2,1,2,22,0,0,2,-1,0,0,14028,16484,15800,16341,16675,0,3000,0,16741,334,0,0,1,11028,16484,-941,16007,16675,0,79328,1,20075,396.64
48,150000,2,5,2,46,0,0,-1,0,0,-2,4463,3034,1170,1170,0,0,1013,1170,0,0,0,0,1,3450,1864,1170,1170,0,0,9837,-3,2183,6.558
49,380000,1,2,2,32,-1,-1,-1,-1,-1,-1,22401,21540,15134,32018,11849,11873,21540,15138,24677,11851,11875,8251,0,861,6402,-9543,20167,-26,3622,114815,-6,93332,30.214473684210525
50,20000,1,1,2,24,0,0,0,0,0,0,17447,18479,19476,19865,20480,20063,1318,1315,704,928,912,1069,0,16129,17164,18772,18937,19568,18994,115810,0,6246,579.05
51,70000,1,3,2,42,1,2,2,2,2,0,37042,36171,38355,39423,38659,39362,0,3100,2000,0,1500,1500,1,37042,33071,36355,39423,37159,37862,229012,9,8100,327.15999999999997
52,100000,2,3,3,43,0,0,0,0,0,0,61559,51163,43824,39619,35762,33258,2000,1606,1500,2000,1500,1000,0,59559,49557,42324,37619,34262,32258,265185,0,9606,265.185
53,310000,2,2,1,49,-2,-2,-2,-2,-2,-2,13465,7867,7600,11185,3544,464,7875,7600,11185,3544,464,0,0,5590,267,-3585,7641,3080,464,44125,-12,30668,14.233870967741936
54,180000,2,1,2,25,1,2,0,0,0,0,41402,41742,42758,43510,44420,45319,1300,2010,1762,1762,1790,1622,0,40102,39732,40996,41748,42630,43697,259151,3,10246,143.97277777777776
55,150000,2,1,2,29,2,0,0,0,0,0,46224,34993,31434,26518,21042,16540,1600,1718,1049,1500,2000,5000,0,44624,33275,30385,25018,19042,11540,176751,2,12867,117.83399999999999
56,500000,2,1,1,45,-2,-2,-2,-2,-2,-2,1905,3640,162,0,151,2530,3640,162,0,151,2530,0,0,-1735,3478,162,-151,-2379,2530,8388,-12,6483,1.6776
57,180000,2,3,1,34,0,0,0,-1,-1,-1,16386,15793,8441,7142,-679,8321,8500,1500,7500,679,9000,2000,0,7886,14293,941,6463,-9679,6321,55404,-3,29179,30.78
58,180000,2,2,1,34,0,0,0,0,0,0,175886,173440,172308,168608,132202,129918,8083,7296,5253,4814,4816,3800,0,167803,166144,167055,163794,127386,126118,952362,0,34062,529.0899999999999
59,200000,2,1,2,34,-1,3,2,2,2,2,1587,1098,782,1166,700,1414,0,0,700,0,1200,0,0,1587,1098,82,1166,-500,1414,6747,10,1900,3.3735
60,400000,2,2,1,29,0,0,0,0,0,0,400134,398857,404205,360199,356656,364089,17000,15029,30000,12000,12000,23000,0,383134,383828,374205,348199,344656,341089,2284140,0,109029,571.035
61,500000,2,3,1,28,0,0,0,0,0,0,22848,23638,18878,14937,13827,15571,1516,1300,1000,1000,2000,2000,1,21332,22338,17878,13937,11827,13571,109699,0,8816,21.9398
62,70000,1,2,1,39,0,0,0,0,0,-1,70800,72060,69938,16518,14096,830,4025,2095,1000,2000,3000,0,0,66775,69965,68938,14518,11096,830,244242,-1,12120,348.91714285714284
63,50000,1,1,2,29,2,2,2,2,2,2,24987,24300,26591,25865,27667,28264,0,2700,0,2225,1200,0,1,24987,21600,26591,23640,26467,28264,157674,12,6125,315.348
64,50000,2,2,1,46,0,0,0,-2,-2,-2,28718,29166,0,0,0,0,1000,0,0,0,0,0,1,27718,29166,0,0,0,0,57884,-6,1000,115.768
65,130000,2,2,1,51,-1,-1,-2,-2,-1,-1,99,0,0,0,2353,0,0,0,0,2353,0,0,0,99,0,0,-2353,2353,0,2452,-8,2353,1.886153846153846
66,200000,1,1,1,57,-2,-2,-2,-1,2,2,152519,148751,144076,8174,8198,7918,0,0,8222,300,0,1000,1,152519,148751,135854,7874,8198,6918,469636,-3,9522,234.818
67,10000,1,2,1,56,2,2,2,0,0,0,2097,4193,3978,4062,4196,4326,2300,0,150,200,200,160,1,-203,4193,3828,3862,3996,4166,22852,6,3010,228.52
68,210000,2,1,2,30,2,-1,-1,-1,-1,-1,300,300,1159,2280,300,4250,300,1159,2280,300,4250,909,0,0,-859,-1121,1980,-3950,3341,8589,-3,9198,4.09
69,130000,2,3,2,29,1,-2,-2,-1,2,-1,-190,-9850,-9850,10311,10161,7319,0,0,20161,0,7319,13899,0,-190,-9850,-30011,10311,2842,-6580,7901,-3,41379,6.077692307692308
70,20000,1,5,2,22,2,0,0,0,0,0,18565,17204,17285,18085,11205,5982,0,1200,1000,500,1000,0,0,18565,16004,16285,17585,10205,5982,88326,2,3700,441.63
71,80000,1,1,2,31,-1,-1,-1,-1,-1,-1,780,0,390,390,390,390,0,390,390,390,390,390,0,780,-390,0,0,0,0,2340,-6,1950,2.9250000000000003
72,320000,1,2,2,29,2,2,2,2,2,2,58267,59246,60184,58622,62307,63526,2500,2500,0,4800,2400,1600,1,55767,56746,60184,53822,59907,61926,362152,12,13800,113.17250000000001
73,200000,2,2,1,32,-1,-1,-1,-1,2,-1,9076,5787,-684,5247,3848,3151,5818,15,9102,17,3165,1395,0,3258,5772,-9786,5230,683,1756,26425,-3,19512,13.212499999999999
74,290000,2,1,2,37,1,-2,-1,-1,-1,-1,0,0,3155,0,2359,0,0,3155,0,2359,0,0,0,0,-3155,3155,-2359,2359,0,5514,-5,5514,1.9013793103448275
75,340000,1,1,2,32,-1,-1,-1,-1,-1,-1,3048,5550,23337,4291,80153,25820,5713,23453,4314,80552,25949,2016,0,-2665,-17903,19023,-76261,54204,23804,142199,-6,141997,41.823235294117644
76,20000,1,2,2,24,0,0,2,0,0,0,14619,17216,16642,16976,17332,18543,2850,0,610,630,1500,0,0,11769,17216,16032,16346,15832,18543,101328,2,5590,506.64
77,50000,1,3,2,25,-1,0,0,0,0,0,42838,37225,36087,9636,9590,10030,1759,1779,320,500,1000,1000,0,41079,35446,35767,9136,8590,9030,145406,-1,6358,290.81199999999995
78,300000,2,1,1,45,-1,-1,-1,-1,-1,-1,291,291,291,291,291,291,291,291,291,291,291,291,0,0,0,0,0,0,0,1746,-6,1746,0.582
79,30000,2,2,2,22,0,0,0,0,0,0,28387,29612,30326,28004,26446,6411,1686,1400,560,3000,1765,0,1,26701,28212,29766,25004,24681,6411,149186,0,8411,497.28666666666663
80,240000,2,2,2,44,1,-2,-2,-2,-2,-2,0,0,0,0,0,0,0,0,0,0,0,0,1,0,0,0,0,0,0,0,-9,0,0.0
81,470000,2,3,3,33,0,0,0,0,0,0,165254,157784,162702,69923,29271,29889,6400,7566,3000,960,1000,3000,0,158854,150218,159702,68963,28271,26889,614823,0,21926,130.81340425531914
82,360000,2,1,2,26,0,0,0,0,0,-1,23411,27796,30400,33100,180000,196,4796,3400,3100,146900,196,2963,0,18615,24396,27300,-113800,179804,-2767,294903,-1,161355,81.9175
83,60000,1,3,2,30,0,0,0,0,0,0,26324,27471,28108,21993,19899,19771,1576,1213,648,768,1140,0,1,24748,26258,27460,21225,18759,19771,143566,0,5345,239.27666666666667
84,400000,2,2,1,44,0,0,2,0,0,0,131595,139060,126819,104430,104990,94058,10700,3,3050,3000,3200,2800,0,120895,139057,123769,101430,101790,91258,700952,2,22753,175.238
85,50000,2,3,2,49,0,0,0,0,0,0,48909,47863,21489,20414,19342,19482,1676,1302,700,699,849,826,0,47233,46561,20789,19715,18493,18656,177499,0,6052,354.998
86,160000,1,2,2,33,0,0,0,0,0,0,130028,107808,71934,118418,118407,120418,4400,3547,80000,4500,4800,4500,0,125628,104261,-8066,113918,113607,115918,667013,0,101747,416.883125
87,360000,2,1,1,45,-1,-1,2,0,-1,-1,390,1170,780,390,390,390,1170,0,0,390,390,390,1,-780,1170,780,0,0,0,3510,-2,2340,0.975
88,160000,2,2,2,32,0,0,0,0,0,-1,3826,4751,6604,8604,7072,766,1147,2000,2000,0,766,2303,0,2679,2751,4604,8604,6306,-1537,31623,-1,8216,19.764375
89,130000,2,1,1,35,0,0,0,-1,-1,-1,81313,117866,17740,1330,7095,1190,40000,5000,1330,7095,1190,2090,0,41313,112866,16410,-5765,5905,-900,226534,-3,56705,174.2569230769231
90,20000,1,3,2,44,2,2,0,0,0,2,8583,8303,9651,10488,12314,11970,0,1651,1000,2000,0,1500,0,8583,6652,8651,8488,12314,10470,61309,6,6151,306.54499999999996
91,200000,1,1,1,53,2,2,2,2,2,2,138180,140774,142460,144098,147124,149531,6300,5500,5500,5500,5000,5000,1,131880,135274,136960,138598,142124,144531,862167,12,32800,431.0835
92,280000,2,1,2,39,-1,-1,-1,0,0,-2,7524,0,3968,3868,0,0,0,3968,0,0,0,0,0,7524,-3968,3968,3868,0,0,15360,-5,3968,5.485714285714286
93,100000,2,1,2,27,-2,-2,-2,-2,-2,-2,-2000,5555,0,0,0,0,7555,0,0,0,0,0,0,-9555,5555,0,0,0,0,3555,-12,7555,3.5549999999999997
94,160000,2,2,1,37,-1,-1,-1,-1,-1,-2,880,1602,840,840,0,0,1602,840,840,0,0,7736,0,-722,762,0,840,0,-7736,4162,-7,11018,2.6012500000000003
95,60000,2,2,2,23,0,0,0,0,0,0,45648,46850,47214,19595,19209,19323,1937,1301,682,690,816,835,0,43711,45549,46532,18905,18393,18488,197839,0,6261,329.7316666666667
96,90000,1,2,2,35,0,0,0,0,0,0,83725,85996,87653,35565,30942,30835,3621,3597,1179,1112,1104,1143,0,80104,82399,86474,34453,29838,29692,354716,0,11756,394.12888888888887
97,360000,1,1,1,43,-1,-1,-1,-1,-1,0,3967,8322,3394,6451,26370,9956,8339,3394,12902,27000,0,68978,0,-4372,4928,-9508,-20549,26370,-59022,58460,-5,120613,16.238888888888887
98,150000,1,1,2,27,0,0,0,0,0,0,86009,86108,89006,89775,87725,40788,4031,10006,3266,4040,1698,800,0,81978,76102,85740,85735,86027,39988,479411,0,23841,319.6073333333334
99,50000,2,3,1,22,0,0,0,0,0,0,18722,18160,16997,13150,8866,7899,1411,1194,379,281,321,197,0,17311,16966,16618,12869,8545,7702,83794,0,3783,167.588
100,20000,1,2,1,38,0,0,0,0,0,-1,17973,19367,19559,18240,17928,150,1699,1460,626,1750,150,0,1,16274,17907,18933,16490,17778,150,93217,-1,5685,466.085
101,140000,1,1,2,32,-2,-2,-2,-2,-2,-2,672,10212,850,415,100,1430,10212,850,415,100,1430,0,0,-9540,9362,435,315,-1330,1430,13679,-12,13007,9.770714285714286
102,380000,2,1,2,30,-2,-2,-1,0,0,0,-81,-303,32475,32891,33564,34056,223,33178,1171,1197,1250,5000,0,-304,-33481,31304,31694,32314,29056,132602,-5,42019,34.89526315789473
103,480000,1,1,1,63,0,0,0,2,2,0,422069,431342,479432,487066,471145,469961,16078,55693,17000,0,18000,24200,0,405991,375649,462432,487066,453145,445761,2761015,4,130971,575.2114583333333
104,50000,2,3,2,22,0,0,0,0,0,0,44698,42254,38347,32496,23477,24094,1767,1362,1002,840,995,904,1,42931,40892,37345,31656,22482,23190,205366,0,6870,410.73199999999997
105,60000,2,2,2,26,2,2,2,2,2,0,56685,55208,59175,60218,55447,55305,0,5000,2511,6,3000,3000,0,56685,50208,56664,60212,52447,52305,342038,10,13517,570.0633333333333
106,70000,2,2,2,24,-1,-1,-2,-2,-2,-1,5580,0,0,0,0,26529,0,0,0,0,26529,2000,0,5580,0,0,0,-26529,24529,32109,-9,28529,45.87
107,80000,2,2,1,36,-1,-1,-1,-1,-1,-1,6108,2861,3277,3319,1150,1150,2861,3279,3319,1150,1150,1035,0,3247,-418,-42,2169,0,115,17865,-6,12794,22.33125
108,350000,1,1,2,52,-1,-1,-1,-1,-1,-1,713,2272,722,867,1150,5263,2272,722,867,1150,5263,5011,0,-1559,1550,-145,-283,-4113,252,10987,-6,15285,3.139142857142857
109,130000,1,2,2,38,0,0,0,-1,-1,-1,171438,178382,39940,120483,44127,126568,10908,0,133657,4566,133841,4796,0,160530,178382,-93717,115917,-89714,121772,680938,-3,287768,523.7984615384615
110,360000,1,2,1,35,1,-2,-2,-2,-2,-2,-103,-103,-103,-103,-103,-103,0,0,0,0,0,0,0,-103,-103,-103,-103,-103,-103,-618,-9,0,-0.17166666666666666
111,330000,2,1,1,31,0,0,2,0,0,0,105879,108431,105594,105896,106491,107289,9260,0,3593,4100,15794,0,0,96619,108431,102001,101796,90697,107289,639580,2,32747,193.8121212121212
112,50000,1,3,1,47,0,0,2,0,0,0,13244,14722,15181,15928,16671,17393,2000,1000,1000,1000,1000,1000,0,11244,13722,14181,14928,15671,16393,93139,2,7000,186.27800000000002
113,280000,1,2,1,41,2,2,2,2,2,3,135673,138532,134813,144401,152174,149415,6500,0,14254,14850,0,5000,0,129173,138532,120559,129551,152174,144415,855008,13,40604,305.36
114,100000,2,1,2,24,0,0,0,0,0,0,52128,52692,54477,56076,60100,59713,2000,2677,3076,5080,3000,2033,0,50128,50015,51401,50996,57100,57680,335186,0,17866,335.186
115,50000,1,2,2,41,0,0,0,0,0,0,19015,19294,20259,20274,20311,19957,1340,1305,700,718,724,684,0,17675,17989,19559,19556,19587,19273,119110,0,5471,238.22
116,30000,1,1,2,24,-1,2,0,0,3,2,18199,17618,18631,21319,20692,21201,0,1312,3000,0,1000,1000,1,18199,16306,15631,21319,19692,20201,117660,6,6312,392.2
117,240000,1,1,2,28,-1,-1,-1,-1,-1,-1,326,326,326,5676,476,326,326,326,5676,476,326,526,0,0,0,-5350,5200,150,-200,7456,-6,7656,3.1066666666666665
118,80000,1,2,2,26,2,0,0,0,0,0,14029,15493,16630,17055,17629,18186,2000,1700,1000,1000,1000,1000,1,12029,13793,15630,16055,16629,17186,99022,2,7700,123.7775
119,400000,1,2,1,34,-1,-1,-1,-1,-1,-1,19660,9666,11867,7839,14837,7959,9677,11867,7839,14837,7959,5712,0,9983,-2201,4028,-6998,6878,2247,71828,-6,57891,17.957
120,240000,2,2,2,38,0,0,0,0,-1,-1,50254,51445,53015,52479,1307,1203,2000,3000,3000,1307,1203,563,0,48254,48445,50015,51172,104,640,209703,-2,11073,87.37625
121,50000,1,3,2,37,2,2,2,3,2,2,46004,45976,48953,48851,49318,51143,1000,4035,1000,1400,2800,0,1,45004,41941,47953,47451,46518,51143,290245,13,10235,580.49
122,450000,1,1,1,40,1,-2,-2,-2,-2,-2,0,0,0,0,0,0,0,0,0,0,0,0,1,0,0,0,0,0,0,0,-9,0,0.0
123,110000,2,1,1,48,1,-2,-2,-2,-2,-2,0,0,0,0,0,0,0,0,0,0,0,0,0,0,0,0,0,0,0,0,-9,0,0.0
124,310000,2,2,1,35,2,0,0,0,0,0,304991,311243,306314,258610,246491,198889,13019,11128,8407,8599,6833,5987,1,291972,300115,297907,250011,239658,192902,1626538,2,53973,524.6896774193549
125,20000,1,1,2,27,0,0,0,0,0,0,19115,18962,19298,19378,19717,15630,1404,1130,600,861,313,0,0,17711,17832,18698,18517,19404,15630,112100,0,4308,560.5
126,20000,1,2,2,23,1,-2,-2,-2,-2,-2,0,0,0,0,0,0,0,0,0,0,0,0,0,0,0,0,0,0,0,0,-9,0,0.0
127,200000,1,3,2,52,0,0,0,0,0,0,110151,99530,98951,100914,103146,104993,3568,3585,3602,3848,3669,3784,0,106583,95945,95349,97066,99477,101209,617685,0,22056,308.8425
128,180000,1,1,1,36,0,0,0,0,0,0,163736,116422,99278,95766,97753,95927,4655,2690,2067,2142,2217,1000,1,159081,113732,97211,93624,95536,94927,668882,0,14771,371.6011111111111
129,50000,1,2,1,51,0,0,0,0,0,0,3347,3899,4503,5347,6375,7077,1000,1066,1300,1500,1200,134,1,2347,2833,3203,3847,5175,6943,30548,0,6200,61.096
130,60000,1,3,1,55,3,2,2,0,0,0,60521,61450,57244,28853,29510,26547,2504,7,1200,1200,1100,1500,0,58017,61443,56044,27653,28410,25047,264125,7,7511,440.20833333333337
131,30000,2,1,2,23,1,-2,-2,-2,-1,-1,4000,5645,3508,-27,13744,5906,5645,3508,27,13771,5911,3024,0,-1645,2137,3481,-13798,7833,2882,32776,-7,31886,109.25333333333333
132,240000,1,1,2,41,1,-1,-1,0,0,-1,95,2622,3301,3164,360,1737,2622,3301,0,360,1737,924,0,-2527,-679,3301,2804,-1377,813,11279,-2,8944,4.699583333333333
133,420000,1,2,1,34,0,0,0,0,0,0,253454,247743,229049,220951,210606,188108,9744,9553,7603,7830,7253,11326,0,243710,238190,221446,213121,203353,176782,1349911,0,53309,321.40738095238095
134,330000,1,3,1,46,0,0,0,0,0,0,227389,228719,229644,227587,227775,228203,8210,8095,8025,8175,8391,8200,0,219179,220624,221619,219412,219384,220003,1369317,0,49096,414.94454545454545
135,30000,2,2,2,22,0,0,0,0,0,0,28452,26145,26712,25350,17603,-780,2000,1400,0,500,0,1560,0,26452,24745,26712,24850,17603,-2340,123482,0,5460,411.6066666666667
136,240000,1,2,1,34,0,0,0,2,2,2,10674,12035,13681,13269,14158,13891,1500,1800,0,1000,0,327,0,9174,10235,13681,12269,14158,13564,77708,6,4627,32.37833333333333
137,150000,1,1,2,27,0,0,0,0,0,0,17444,19342,22000,24614,27200,30229,2500,3000,3000,3000,3500,5000,0,14944,16342,19000,21614,23700,25229,140829,0,20000,93.886
138,210000,2,2,1,33,0,0,0,0,0,0,7166,7997,8792,9189,4404,5708,1500,1500,1000,500,2000,546,0,5666,6497,7792,8689,2404,5162,43256,0,7046,20.598095238095237
139,50000,2,3,1,51,-1,-1,-1,-1,-2,-2,752,300,5880,0,0,0,300,5880,0,0,0,0,1,452,-5580,5880,0,0,0,6932,-8,6180,13.864
140,50000,1,1,2,24,0,0,0,0,0,0,50801,50143,49586,19430,19375,18995,2360,1700,1000,900,870,2130,0,48441,48443,48586,18530,18505,16865,208330,0,8960,416.65999999999997
141,240000,1,1,2,47,1,-2,-2,-2,-2,-2,0,0,0,0,0,0,0,0,0,0,0,0,1,0,0,0,0,0,0,0,-9,0,0.0
142,180000,1,2,2,28,-1,-1,-1,-1,-1,-1,1832,0,832,332,416,416,0,416,332,500,3500,832,0,1832,-416,500,-168,-3084,-416,3828,-6,5580,2.1266666666666665
143,50000,1,2,2,23,1,2,2,2,0,0,10131,10833,20583,19996,19879,18065,1000,10000,400,700,800,600,0,9131,833,20183,19296,19079,17465,99487,7,13500,198.97400000000002
144,170000,1,2,2,29,-2,-2,-2,-2,-2,-2,12159,10000,10000,10000,9983,15846,10000,10000,10000,9983,15863,10000,0,2159,0,0,17,-5880,5846,67988,-12,65846,39.99294117647059
145,20000,1,1,2,29,-1,-1,-1,-1,0,-1,1199,15586,344,2340,6702,339,15586,344,2340,4702,339,330,0,-14387,15242,-1996,-2362,6363,9,26510,-5,23641,132.54999999999998
146,50000,1,1,2,28,0,0,0,0,0,3,4999,5913,7315,9195,10624,10138,1000,1500,2000,1583,1100,0,0,3999,4413,5315,7612,9524,10138,48184,3,7183,96.368
147,170000,2,2,2,27,0,0,0,0,0,0,19269,20313,20852,17560,17918,9100,1661,1200,351,358,182,0,1,17608,19113,20501,17202,17736,9100,105012,0,3752,61.77176470588235
148,200000,1,1,2,34,1,2,0,0,0,0,197236,176192,93069,135668,132233,59875,8000,5000,55500,5000,5000,8500,0,189236,171192,37569,130668,127233,51375,794273,3,87000,397.1365
149,80000,2,2,1,23,1,2,3,2,0,0,9168,10522,10205,9898,10123,12034,1650,0,0,379,2091,1,0,7518,10522,10205,9519,8032,12033,61950,8,4121,77.4375
150,260000,2,1,1,60,1,-2,-1,-1,-1,-1,-1100,-1100,21400,0,969,869,0,22500,0,969,1000,0,0,-1100,-23600,21400,-969,-31,869,21038,-5,24469,8.09153846153846
151,140000,1,2,1,32,0,0,0,0,2,0,86627,78142,68336,64648,58319,55251,3455,3110,5000,0,2100,2602,0,83172,75032,63336,64648,56219,52649,411323,2,16267,293.8021428571429
152,80000,1,1,2,25,0,0,0,0,0,0,42444,55744,43476,41087,41951,31826,30000,3000,6000,8000,2000,14000,0,12444,52744,37476,33087,39951,17826,256528,0,63000,320.65999999999997
153,350000,1,1,2,41,1,-1,-1,-1,-1,-2,208,2906,1000,630,0,0,2906,1000,630,0,0,0,0,-2698,1906,370,630,0,0,4744,-5,4536,1.3554285714285714
154,280000,2,2,1,56,0,0,0,0,0,0,208775,182350,132257,101783,177145,169311,8042,6700,5137,100000,7000,6321,0,200733,175650,127120,1783,170145,162990,971621,0,133200,347.0075
155,30000,2,3,2,26,0,0,0,0,0,0,9014,10406,11427,11935,13084,14206,1700,1500,1000,1500,1500,1500,0,7314,8906,10427,10435,11584,12706,70072,0,8700,233.57333333333332
156,140000,1,1,1,34,0,0,0,0,0,0,23944,28049,32073,43129,47086,48699,5000,5000,11885,5000,3000,5504,0,18944,23049,20188,38129,44086,43195,222980,0,35389,159.27142857142857
157,200000,2,1,2,37,0,0,0,0,0,0,105420,102870,89643,90938,92505,94031,4000,3250,3250,3500,3560,5000,0,101420,99620,86393,87438,88945,89031,575407,0,22560,287.70349999999996
158,200000,2,3,2,30,0,0,0,0,0,0,196031,196143,189524,167163,146975,122324,7300,7108,7680,6200,5000,4500,0,188731,189035,181844,160963,141975,117824,1018160,0,37788,509.08
159,210000,1,3,1,45,2,3,4,4,5,6,115785,122904,129847,137277,145533,154105,10478,10478,11078,11078,11678,10478,1,105307,112426,118769,126199,133855,143627,805451,24,65268,383.54809523809524
160,50000,1,3,1,57,3,2,0,0,0,0,12854,12362,13447,13427,13711,14083,0,1600,500,500,600,600,0,12854,10762,12947,12927,13111,13483,79884,5,3800,159.768
161,30000,1,1,2,41,2,2,2,2,2,0,24357,27453,26718,28168,27579,28321,3500,0,2200,0,1200,1250,0,20857,27453,24518,28168,26379,27071,162596,10,8150,541.9866666666667
162,50000,1,2,2,27,2,-1,-1,-1,-1,2,390,390,780,216,1080,540,390,780,216,864,0,390,0,0,-390,564,-648,1080,150,3396,0,2640,6.792
163,290000,1,3,1,47,-1,-1,-1,-1,0,-1,1234,396,396,792,396,423,396,396,792,0,423,369,0,838,0,-396,792,-27,54,3637,-5,2376,1.254137931034483
164,250000,2,1,1,34,0,0,2,0,0,0,141223,156858,151841,152803,155997,160220,17994,0,5469,5656,6811,3920,0,123229,156858,146372,147147,149186,156300,918942,2,39850,367.5768
165,60000,2,2,1,46,0,0,0,0,0,0,21148,23803,24908,26034,26655,27756,3000,1500,1500,1000,1500,1500,0,18148,22303,23408,25034,25155,26256,150304,0,10000,250.50666666666666
166,110000,2,1,2,27,0,0,0,0,0,0,101640,104795,104855,74737,76058,77254,5500,3900,3000,2900,3000,2800,0,96140,100895,101855,71837,73058,74454,539339,0,21100,490.3081818181819
167,370000,1,1,2,50,-2,-2,-2,-2,-2,-2,6093,15130,8204,15398,4792,13453,15383,8204,15413,4792,13453,4699,0,-9290,6926,-7209,10606,-8661,8754,63070,-12,61944,17.045945945945945
168,100000,1,2,1,27,-1,2,2,0,0,0,102349,96847,58824,29336,22979,-246,3166,0,1330,1398,12,50000,0,99183,96847,57494,27938,22967,-50246,310089,3,55906,310.089
169,90000,2,2,1,35,0,0,0,0,0,2,72112,73854,75526,77317,85852,88290,3500,3500,3652,10000,4000,0,0,68612,70354,71874,67317,81852,88290,472951,2,24652,525.5011111111111
170,50000,2,2,2,22,0,0,0,0,0,0,28040,29092,29366,27737,28318,28806,1510,1442,982,1017,1277,567,0,26530,27650,28384,26720,27041,28239,171359,0,6795,342.71799999999996
171,270000,1,2,2,37,0,0,0,0,0,0,37695,33397,30534,27598,26344,24641,5000,2000,3000,4000,3000,2000,0,32695,31397,27534,23598,23344,22641,180209,0,19000,66.74407407407408
172,300000,2,1,2,30,-1,-1,-1,-1,-1,-1,688,3280,0,4340,2672,800,3288,0,4340,2672,800,746,0,-2600,3280,-4340,1668,1872,54,11780,-6,11846,3.9266666666666663
173,50000,2,2,2,22,-1,0,0,0,0,0,8567,15273,11650,7457,3115,7725,15000,1000,149,0,5000,10000,0,-6433,14273,11501,7457,-1885,-2275,53787,-1,31149,107.574
174,50000,2,1,2,24,1,-2,-2,-2,-2,-2,-709,-709,-709,-2898,-3272,-3272,0,0,0,0,0,0,1,-709,-709,-709,-2898,-3272,-3272,-11569,-9,0,-23.138
175,360000,1,1,2,29,1,-2,-1,-1,-2,-2,0,0,77,0,0,0,0,77,0,0,0,0,0,0,-77,77,0,0,0,77,-7,77,0.021388888888888888
176,130000,1,3,1,56,1,2,2,2,2,3,64617,65978,67282,68557,72796,71345,3000,3000,3000,5500,0,0,1,61617,62978,64282,63057,72796,71345,410575,12,14500,315.82692307692304
177,80000,1,1,2,30,-2,-1,0,0,0,0,6187,100,600,1438,1919,5380,504,500,1000,500,3500,0,0,5683,-400,-400,938,-1581,5380,15624,-3,6004,19.53
178,50000,1,2,2,30,1,2,0,0,0,2,48860,47801,48363,30221,22877,22361,0,1500,1000,2000,0,2000,0,48860,46301,47363,28221,22877,20361,220483,5,6500,440.96599999999995
179,20000,2,2,2,22,0,0,0,0,0,0,16001,12622,13221,13130,14034,14906,1212,1201,500,1500,1500,1000,0,14789,11421,12721,11630,12534,13906,83914,0,6913,419.57000000000005
180,80000,2,2,1,29,0,0,2,0,0,0,77883,81811,80250,61467,10662,11486,5800,1000,600,400,1000,0,0,72083,80811,79650,61067,9662,11486,323559,2,8800,404.44874999999996
181,240000,1,1,2,37,-1,-1,2,0,0,-1,12212,26578,25331,26605,26279,1256,15000,0,2000,0,1256,65935,0,-2788,26578,23331,26605,25023,-64679,118261,-1,84191,49.275416666666665
182,80000,2,3,2,35,0,-1,0,0,0,0,49608,12412,14873,17364,17770,17460,12500,6500,3000,2000,3000,2000,0,37108,5912,11873,15364,14770,15460,129487,-1,29000,161.85875000000001
183,500000,2,1,1,47,0,0,0,0,0,0,56422,110616,110340,122967,108834,70064,70010,30357,30000,20000,52183,20000,0,-13588,80259,80340,102967,56651,50064,579243,0,222550,115.84859999999999
184,60000,2,2,1,24,0,0,0,0,0,0,58024,57891,48839,18971,19323,19395,2500,1600,3000,1000,737,2000,1,55524,56291,45839,17971,18586,17395,222443,0,10837,370.73833333333334
185,20000,1,2,2,25,0,0,0,0,0,-1,10642,11677,13070,12280,1615,1620,1200,1593,601,135,1824,0,0,9442,10084,12469,12145,-209,1620,50904,-1,5353,254.51999999999998
186,100000,2,2,1,38,1,2,0,0,2,0,14483,13961,15323,16268,15868,16448,0,1600,1500,0,1000,1500,1,14483,12361,13823,16268,14868,14948,92351,5,5600,92.351
187,360000,2,1,2,32,1,-1,-1,-1,-1,-1,2616,57077,5287,68445,13881,16240,57087,5295,68454,13889,16250,38313,0,-54471,51782,-63167,54556,-2369,-22073,163546,-4,199288,45.42944444444444
188,200000,2,3,2,47,2,2,2,2,2,2,199436,202947,193936,196186,200162,189915,8214,7000,6800,7134,0,6836,1,191222,195947,187136,189052,200162,183079,1182582,12,35984,591.291
189,130000,2,2,1,34,1,-1,0,0,0,0,0,5396,10270,13576,13864,14636,5396,5000,3500,501,1000,2000,0,-5396,396,6770,13075,12864,12636,57742,0,17397,44.41692307692308
190,20000,2,2,2,31,1,5,4,4,3,2,21703,21087,21461,20835,20219,20487,0,1000,0,0,760,0,0,21703,20087,21461,20835,19459,20487,125792,19,1760,628.96
191,310000,1,1,2,32,0,0,0,0,0,0,59901,62147,62102,65875,60387,43328,10020,6031,10057,5028,5060,4223,0,49881,56116,52045,60847,55327,39105,353740,0,40419,114.10967741935485
192,60000,2,1,2,27,2,0,0,0,2,0,19625,20347,21669,23005,22499,22873,1342,1664,2000,0,900,846,1,18283,18683,19669,23005,21599,22027,130018,4,6752,216.69666666666666
193,180000,2,1,2,29,-1,-1,-1,-2,-1,0,11386,199,0,0,17227,17042,199,0,0,17227,341,5114,0,11187,199,0,-17227,16886,11928,45854,-6,22881,25.474444444444444
194,180000,2,1,2,24,-1,-1,2,0,0,-2,14670,22087,21282,10200,0,0,37867,0,200,0,0,0,0,-23197,22087,21082,10200,0,0,68239,-2,38067,37.910555555555554
195,50000,1,2,1,36,0,0,0,0,-1,-1,47790,18114,18250,-14,72,658,2000,1000,2000,500,1000,20011,0,45790,17114,16250,-514,-928,-19353,84870,-2,26511,169.74
196,50000,2,1,2,24,1,2,2,2,2,2,36166,37188,37680,38462,39228,40035,1900,1400,1700,1532,1600,0,1,34266,35788,35980,36930,37628,40035,228759,11,8132,457.518
197,150000,2,2,1,34,-2,-2,-2,-2,-2,-2,0,0,0,116,0,1500,0,0,116,0,1500,0,0,0,0,-116,116,-1500,1500,1616,-12,1616,1.0773333333333333
198,20000,2,1,2,22,0,0,0,0,-1,0,18553,19446,19065,8332,18868,19247,1500,1032,541,20000,693,1000,0,17053,18414,18524,-11668,18175,18247,103511,-1,24766,517.5550000000001
199,500000,2,1,1,34,-2,-2,-2,-1,-1,-1,412,138,2299,1251,1206,1151,138,2299,1251,1206,1151,15816,0,274,-2161,1048,45,55,-14665,6457,-9,21861,1.2914
200,30000,2,3,2,22,1,2,2,0,0,0,29010,29256,28122,29836,1630,0,1000,85,1714,104,0,0,1,28010,29171,26408,29732,1630,0,117854,5,2903,392.84666666666664
201,180000,2,1,1,38,-2,-2,-2,-2,-2,-2,750,0,0,0,0,0,0,0,0,0,0,0,0,750,0,0,0,0,0,750,-12,0,0.4166666666666667
202,140000,1,1,2,31,0,0,2,0,0,2,27123,27299,17985,20225,27407,10833,25000,0,3000,7800,0,2500,0,2123,27299,14985,12425,27407,8333,130872,4,38300,93.47999999999999
203,140000,2,1,2,26,-1,0,-1,-1,-1,-1,13424,18000,13001,5818,13506,487,10000,13001,5841,13506,487,7004,0,3424,4999,7160,-7688,13019,-6517,64236,-5,49839,45.88285714285714
204,120000,1,2,2,26,0,0,0,0,0,0,107314,110578,113736,116000,119131,122135,5000,5000,4152,5000,5000,5000,0,102314,105578,109584,111000,114131,117135,688894,0,29152,574.0783333333333
205,360000,2,2,1,48,0,0,0,0,0,0,226430,231878,234192,190211,173557,146511,9100,7300,5800,5600,5600,4100,0,217330,224578,228392,184611,167957,142411,1202779,0,37500,334.10527777777776
206,20000,1,3,1,43,-1,-1,0,0,0,0,227,20351,20237,19339,19450,19337,22359,1305,1258,1459,3457,1700,0,-22132,19046,18979,17880,15993,17637,98941,-2,31538,494.705
207,100000,1,1,1,47,-1,-1,-1,-1,-1,-1,390,1473,390,390,390,0,1473,390,390,390,0,2380,0,-1083,1083,0,0,390,-2380,3033,-6,5023,3.033
208,210000,2,2,1,41,-1,-1,-1,-1,-1,-1,3088,1586,343,3763,877,0,1586,343,3763,877,0,419,1,1502,1243,-3420,2886,877,-419,9657,-6,6988,4.598571428571428
209,80000,2,2,2,24,0,0,0,0,0,0,81625,81554,79599,49552,49509,49568,3200,3000,2038,2000,1800,1800,1,78425,78554,77561,47552,47709,47768,391407,0,13838,489.25875
210,330000,2,1,1,50,-1,-1,-1,-1,-2,-2,8872,4337,2854,1690,0,1709,4345,2854,1702,0,1709,258,0,4527,1483,1152,1690,-1709,1451,19462,-8,10868,5.8975757575757575
211,220000,1,1,2,24,0,0,0,-1,-1,-1,105607,108917,111520,8303,0,85632,5000,5050,8303,0,85632,0,0,100607,103867,103217,8303,-85632,85632,419979,-3,103985,190.89954545454546
212,210000,2,1,1,38,1,-2,-1,0,-1,-1,0,0,250,123,789,1222,0,250,0,789,1222,9616,1,0,-250,250,-666,-433,-8394,2384,-4,11877,1.1352380952380952
213,40000,2,3,1,43,0,0,0,0,0,0,38257,38901,38103,36207,33138,31339,1700,1504,1200,1500,1500,1000,0,36557,37397,36903,34707,31638,30339,215945,0,8404,539.8625
214,30000,1,2,2,39,0,0,0,2,0,0,28347,28108,18388,12992,7736,8032,3036,2309,0,1000,2000,148,0,25311,25799,18388,11992,5736,7884,103603,2,8493,345.34333333333336
215,470000,1,2,2,27,2,2,2,2,0,0,296573,303320,307843,479978,305145,309959,13000,11001,0,10484,10838,10367,0,283573,292319,307843,469494,294307,299592,2002818,8,55690,426.1314893617021
216,30000,1,3,1,42,-1,-1,-1,-1,-1,2,390,390,390,240,1320,780,390,390,240,1470,0,0,0,0,0,150,-1230,1320,780,3510,-3,2490,11.700000000000001
217,240000,2,2,1,36,1,-2,-2,-2,-2,-2,-946,-946,-946,-946,-946,-946,0,0,0,0,0,0,1,-946,-946,-946,-946,-946,-946,-5676,-9,0,-2.365
218,80000,1,2,2,36,2,0,0,0,0,0,79278,78501,78534,80016,76235,78245,3100,3500,3400,3000,3500,3000,0,76178,75001,75134,77016,72735,75245,470809,2,19500,588.51125
219,110000,2,3,0,31,0,0,0,0,0,0,89989,84229,79288,73315,63818,63208,4000,5000,3000,3000,3000,8954,0,85989,79229,76288,70315,60818,54254,453847,0,26954,412.5881818181818
220,310000,2,1,2,38,-1,-1,-1,-1,-2,-2,1424,4542,126,0,0,0,4542,126,0,0,0,0,0,-3118,4416,126,0,0,0,6092,-8,4668,1.9651612903225806
221,360000,2,1,1,40,2,2,2,0,0,0,105167,115468,112157,114690,117845,120238,12000,0,5900,5000,4500,4700,1,93167,115468,106257,109690,113345,115538,685565,6,32100,190.4347222222222
222,330000,2,3,2,45,0,0,0,0,0,0,335196,334954,335527,333860,335760,330121,12388,12378,12116,12450,12213,11678,0,322808,322576,323411,321410,323547,318443,2005418,0,73223,607.7024242424242
223,300000,2,2,2,35,0,0,0,0,0,0,291619,297268,205629,215827,208464,212508,12019,9006,17000,12000,9557,15000,0,279600,288262,188629,203827,198907,197508,1431315,0,74582,477.10499999999996
224,320000,2,2,2,33,0,0,0,0,0,0,91653,94037,108597,65913,43805,33263,10042,18832,2117,2076,5045,3754,0,81611,75205,106480,63837,38760,29509,437268,0,41866,136.64624999999998
225,50000,2,3,2,37,1,3,2,0,0,0,52626,51537,49205,30394,30249,29957,0,24,1500,1000,1201,30592,1,52626,51513,47705,29394,29048,-635,243968,6,34317,487.93600000000004
226,170000,2,1,2,28,0,0,0,0,0,0,130370,131199,128900,125514,127280,128839,6530,4860,22500,4820,4877,4962,0,123840,126339,106400,120694,122403,123877,772102,0,48549,454.17764705882354
227,350000,1,3,1,44,-1,-1,-1,-1,-1,-2,3265,2686,1864,569,0,0,2686,1864,569,0,0,0,0,579,822,1295,569,0,0,8384,-7,5119,2.3954285714285715
228,20000,1,2,1,37,0,0,0,0,0,0,16455,16511,18902,18768,18650,19175,1609,3000,663,676,834,782,0,14846,13511,18239,18092,17816,18393,108461,0,7564,542.305
229,50000,1,2,2,23,2,0,0,0,0,0,49758,48456,44116,21247,20066,18858,2401,2254,2004,704,707,1004,1,47357,46202,42112,20543,19359,17854,202501,2,9074,405.002
230,20000,2,3,2,24,1,2,0,0,0,0,19154,18165,17233,7630,1730,0,0,1333,500,100,0,3200,0,19154,16832,16733,7530,1730,-3200,63912,3,5133,319.56
231,50000,2,1,2,24,0,0,0,0,0,0,35084,35796,30937,19420,10385,1308,2090,2002,1002,238,1011,389,0,32994,33794,29935,19182,9374,919,132930,0,6732,265.86
232,20000,1,2,2,23,1,2,0,0,2,0,20235,17132,16856,16875,13454,10104,0,1200,1000,0,1000,10000,1,20235,15932,15856,16875,12454,104,94656,5,13200,473.28000000000003
233,50000,1,2,1,26,0,0,-2,-1,-1,0,102800,0,0,2624,45567,46557,0,0,2624,45567,1747,2000,0,102800,0,-2624,-42943,43820,44557,197548,-4,51938,395.096
234,190000,1,2,2,34,2,0,0,0,2,2,129801,131383,134379,142323,140120,150052,5000,5000,10000,0,12118,2769,1,124801,126383,124379,142323,128002,147283,828058,6,34887,435.82
235,60000,2,2,1,33,0,0,0,0,0,0,58203,36367,20934,20694,20175,19421,1506,1298,1000,721,811,599,0,56697,35069,19934,19973,19364,18822,175794,0,5935,292.99
236,80000,1,1,2,35,-1,-1,-1,-1,-1,-1,7988,3977,6848,1719,1378,19942,3983,6853,1719,1378,19942,2418,0,4005,-2876,5129,341,-18564,17524,41852,-6,36293,52.315
237,150000,2,2,2,27,0,0,0,0,0,0,127402,110050,51547,44384,36900,29497,4500,1745,1566,1208,1077,2529,0,122902,108305,49981,43176,35823,26968,399780,0,12625,266.52
238,210000,2,1,2,31,-2,-2,-2,-2,-1,-1,1440,0,7422,893,6082,2293,0,7422,893,6082,2293,3299,0,1440,-7422,6529,-5189,3789,-1006,18130,-10,19989,8.633333333333333
239,240000,2,3,1,50,0,0,0,0,0,0,234205,231669,214642,207642,210375,214694,10116,9150,8008,8000,8009,7714,1,224089,222519,206634,199642,202366,206980,1313227,0,50997,547.1779166666666
240,140000,2,2,3,41,0,0,0,0,0,0,19346,21708,22940,19068,16409,16383,3000,2000,2198,1000,3000,2399,1,16346,19708,20742,18068,13409,13984,115854,0,13597,82.75285714285714
241,60000,2,1,2,28,1,2,2,-2,-2,-1,21501,20650,0,0,0,2285,0,0,0,0,2285,0,0,21501,20650,0,0,-2285,2285,44436,0,2285,74.06
242,50000,1,1,2,39,0,0,0,0,0,0,47174,47974,48630,50803,30789,15874,1800,2000,3000,2000,2000,2000,0,45374,45974,45630,48803,28789,13874,241244,0,12800,482.48800000000006
243,50000,2,2,2,27,0,0,0,0,0,0,26655,27724,28676,27990,28790,29399,1800,1750,900,1200,1200,1100,0,24855,25974,27776,26790,27590,28299,169234,0,7950,338.468
244,180000,2,1,2,32,-1,-1,2,2,-1,-1,3139,5853,2821,0,2821,0,2821,0,0,2821,0,176,0,318,5853,2821,-2821,2821,-176,14634,0,5818,8.129999999999999
245,30000,2,1,2,40,-1,-1,2,2,2,2,142,215,139,19,19,79,355,120,0,0,60,60,0,-213,95,139,19,-41,19,613,6,595,2.0433333333333334
246,20000,2,2,2,40,0,0,0,0,0,-2,19816,20396,20102,19575,0,0,1601,2203,2114,0,0,0,0,18215,18193,17988,19575,0,0,79889,-2,5918,399.445
247,250000,2,2,1,75,0,-1,-1,-1,-1,-1,52874,1631,1536,1010,5572,794,1631,1536,1010,5572,794,1184,0,51243,95,526,-4562,4778,-390,63417,-5,11727,25.3668
248,100000,2,2,2,27,0,0,0,0,0,0,37767,34457,30036,30337,30997,32904,1788,1799,1100,1150,2423,0,0,35979,32658,28936,29187,28574,32904,196498,0,8260,196.498
249,330000,1,1,2,25,0,0,0,0,2,0,46140,45781,48139,51137,39450,25358,2504,4007,5056,74,1023,2566,0,43636,41774,43083,51063,38427,22792,256005,2,15230,77.57727272727273
250,50000,1,3,1,46,0,0,0,0,0,0,35713,15392,16099,16418,16765,17484,1561,1268,587,611,1000,2000,0,34152,14124,15512,15807,15765,15484,117871,0,7027,235.742
251,50000,2,2,2,26,1,2,2,0,0,0,50867,51486,48869,30115,29527,29998,1710,136,1206,2002,2005,3003,0,49157,51350,47663,28113,27522,26995,240862,5,10062,481.724
252,30000,1,2,2,28,0,0,0,0,0,0,29242,29507,29155,25255,22001,0,5006,1244,851,955,0,0,0,24236,28263,28304,24300,22001,0,135160,0,8056,450.53333333333336
253,140000,2,2,2,26,0,0,0,0,0,0,101551,105246,104781,105334,107699,106828,5366,5087,3605,3894,3785,3304,1,96185,100159,101176,101440,103914,103524,631439,0,25041,451.02785714285716
254,160000,2,1,2,28,0,0,0,0,-1,0,70243,47779,28052,7222,99669,84426,7042,2000,1000,99669,12600,10000,0,63201,45779,27052,-92447,87069,74426,337391,-1,132311,210.869375
255,400000,2,2,2,29,-1,0,-1,-1,-1,-1,19532,3719,1453,4944,1896,2486,3127,1469,4968,1905,2494,862,0,16405,2250,-3515,3039,-598,1624,34030,-5,14825,8.5075
256,50000,1,2,1,25,0,0,0,0,0,0,27699,28513,29341,29928,29533,28538,1565,1393,980,994,1024,886,0,26134,27120,28361,28934,28509,27652,173552,0,6842,347.104
257,140000,2,2,1,48,0,-1,-1,-1,-1,-1,1154,1233,862,1355,1130,21361,1233,1075,1355,1130,21361,1347,0,-79,158,-493,225,-20231,20014,27095,-5,27501,19.353571428571428
258,160000,2,2,1,33,-1,-1,-1,-1,0,-1,8015,2453,9624,52572,7333,2210,2453,9880,52572,1546,2210,0,0,5562,-7427,-42948,51026,5123,2210,82207,-5,68661,51.379375
259,100000,2,3,1,43,0,0,-2,-2,-2,-2,62170,0,0,0,0,0,0,0,0,0,0,0,0,62170,0,0,0,0,0,62170,-8,0,62.17
260,220000,1,1,1,48,2,0,0,0,0,0,210380,213522,201852,169115,172169,162402,10000,9020,6000,5500,6000,5500,1,200380,204502,195852,163615,166169,156902,1129440,2,42020,513.3818181818182
261,510000,2,1,2,29,0,0,0,0,0,0,78331,99414,107686,103776,87265,36739,40010,20094,5000,5001,25365,65000,0,38321,79320,102686,98775,61900,-28261,513211,0,160470,100.62960784313726
262,50000,1,2,2,29,0,0,0,0,0,0,49276,35100,32563,27823,29130,28309,1602,1400,3000,3130,1062,6318,0,47674,33700,29563,24693,28068,21991,202201,0,16512,404.402
263,160000,2,1,1,38,-1,-1,-1,-1,2,-1,4473,4664,5969,18941,16578,12652,4664,5969,18941,0,12652,1916,0,-191,-1305,-12972,18941,3926,10736,63277,-3,44142,39.548125
264,230000,2,1,2,37,-2,-2,-2,-2,-2,-2,2283,50815,0,0,299,338,51315,0,0,299,338,0,0,-49032,50815,0,-299,-39,338,53735,-12,51952,23.36304347826087
265,80000,2,1,2,37,-1,-1,-1,-1,-1,-1,10115,249,5986,188,1644,16872,258,5995,188,1644,16872,4000,0,9857,-5746,5798,-1456,-15228,12872,35054,-6,28957,43.817499999999995
266,150000,2,2,1,25,-1,-1,-2,-1,-1,-1,6156,0,0,316,316,316,0,0,316,316,316,316,0,6156,0,-316,0,0,0,7104,-7,1264,4.736
267,10000,1,3,2,23,0,0,0,0,0,2,6974,7838,9002,9182,9729,9411,1134,1298,478,847,0,175,0,5840,6540,8524,8335,9729,9236,52136,2,3932,521.3599999999999
268,130000,2,3,2,49,0,0,0,0,0,0,89003,91362,72197,49654,28065,27500,4100,3095,1630,561,600,0,1,84903,88267,70567,49093,27465,27500,357781,0,9986,275.2161538461539
269,40000,2,1,2,48,0,0,0,0,0,0,34871,34449,33634,34586,34762,35673,1600,1600,1500,1500,1500,1500,0,33271,32849,32134,33086,33262,34173,207975,0,9200,519.9375
270,50000,1,2,2,27,3,2,2,0,0,-1,13694,14880,14242,13968,14319,2614,1700,0,426,501,2614,1390,1,11994,14880,13816,13467,11705,1224,73717,6,6631,147.434
271,100000,1,3,2,32,0,0,0,0,0,0,70003,31545,20974,19713,19848,18126,2035,2004,616,2007,1009,2015,0,67968,29541,20358,17706,18839,16111,180209,0,9686,180.209
272,120000,1,1,1,34,-1,2,-1,0,0,0,1082,632,1350,900,450,0,0,1350,0,0,0,450,0,1082,-718,1350,900,450,-450,4414,0,1800,3.6783333333333337
273,260000,2,1,2,58,1,-2,-2,-2,-2,-2,0,0,0,0,0,0,0,0,0,0,0,0,1,0,0,0,0,0,0,0,-9,0,0.0
274,200000,2,2,2,33,0,0,0,0,0,0,11253,12852,14024,14512,16325,11905,2000,1322,2000,2000,1200,3000,0,9253,11530,12024,12512,15125,8905,80871,0,11522,40.435500000000005
275,360000,2,2,2,28,-2,-2,-2,-2,-2,-2,0,0,0,0,0,0,0,0,0,0,0,0,1,0,0,0,0,0,0,0,-12,0,0.0
276,70000,2,2,2,36,0,0,0,0,0,0,68699,69120,68376,30163,14310,15085,4483,12496,3268,3000,3000,2000,0,64216,56624,65108,27163,11310,13085,265753,0,28247,379.64714285714285
277,460000,1,1,1,40,2,-1,-1,-1,-1,-1,171,2715,-13,2641,-10,22535,2728,0,2654,0,22545,0,1,-2557,2715,-2667,2641,-22555,22535,28039,-3,27927,6.095434782608695
278,50000,2,1,2,26,-1,-1,-1,-1,-1,-1,1156,316,316,316,316,316,316,316,316,316,316,316,0,840,0,0,0,0,0,2736,-6,1896,5.4719999999999995
279,50000,1,3,1,33,0,0,0,0,0,0,50859,50462,50654,20046,20067,19703,2007,2199,691,707,703,697,0,48852,48263,49963,19339,19364,19006,211791,0,7004,423.58200000000005
280,250000,2,2,1,31,0,0,0,0,0,0,103109,102594,97109,99029,100871,101299,4000,4500,5000,4000,5000,4400,0,99109,98094,92109,95029,95871,96899,604011,0,26900,241.6044
281,30000,2,1,2,27,0,0,-1,0,0,-2,1512,2458,664,1814,0,0,1000,664,1500,0,0,0,0,512,1794,-836,1814,0,0,6448,-3,3164,21.493333333333332
282,270000,1,2,1,44,0,0,0,0,-1,-1,127543,109189,92630,69669,44149,43414,10063,5162,10150,44299,43509,31031,0,117480,104027,82480,25370,640,12383,486594,-2,144214,180.22
283,180000,2,3,2,30,0,0,0,0,0,0,163935,153152,147032,122196,103692,70204,7722,6091,3563,3605,3000,3211,0,156213,147061,143469,118591,100692,66993,760211,0,27192,422.33944444444444
284,100000,2,1,2,28,0,0,0,0,0,0,53494,52656,52600,52336,55831,56265,4173,3000,2025,5000,3000,3000,0,49321,49656,50575,47336,52831,53265,323182,0,20198,323.182
285,230000,2,3,1,32,0,0,0,0,0,0,195126,88743,92195,94814,98182,98457,5000,5000,5000,5000,4000,5000,0,190126,83743,87195,89814,94182,93457,667517,0,29000,290.22478260869565
286,210000,2,1,1,46,-1,-1,-1,-1,-1,-1,110346,41986,21874,20076,16171,586,41986,21874,20076,16171,586,19777,0,68360,20112,1798,3905,15585,-19191,211039,-6,120470,100.4947619047619
287,210000,1,1,2,38,2,0,0,0,0,0,60502,62804,62769,62683,63663,46549,3276,2026,2000,2000,2000,2502,0,57226,60778,60769,60683,61663,44047,358970,2,13804,170.93809523809526
288,440000,2,2,1,46,0,0,0,0,0,0,180641,181557,149944,113135,105280,97622,8610,6907,3727,3800,4001,2701,0,172031,174650,146217,109335,101279,94921,828179,0,29746,188.2225
289,100000,2,2,2,25,2,0,0,0,0,0,70896,71678,70125,69856,69718,51365,3472,2092,2000,2127,1960,1559,1,67424,69586,68125,67729,67758,49806,403638,2,13210,403.63800000000003
290,240000,2,2,1,46,0,0,0,0,0,0,8751,9900,10605,10765,11765,4311,1295,1000,1000,1000,1000,1000,0,7456,8900,9605,9765,10765,3311,56097,0,6295,23.373749999999998
291,280000,1,1,2,33,-1,-1,-1,-1,-1,-1,898,898,325,898,325,-339603,898,325,898,325,0,345293,1,0,573,-573,573,325,-684896,-336259,-6,347739,-120.0925
292,50000,2,2,2,22,1,-2,-2,-2,-2,-2,0,0,0,0,0,0,0,0,0,0,0,0,1,0,0,0,0,0,0,0,-9,0,0.0
293,30000,1,2,1,43,3,2,2,2,2,2,1700,2610,1914,2182,2000,2566,1100,0,300,0,600,0,0,600,2610,1614,2182,1400,2566,12972,13,2000,43.24
294,10000,1,2,2,27,0,0,2,0,0,0,7015,10227,9560,9901,9963,10182,3507,0,500,370,393,700,1,3508,10227,9060,9531,9570,9482,56848,2,5470,568.48
295,130000,1,1,2,29,1,-2,-2,-2,-2,-2,0,0,0,0,0,0,0,0,0,0,0,1500,0,0,0,0,0,0,-1500,0,-9,1500,0.0
296,200000,1,1,2,31,0,0,0,0,0,0,194353,197344,186292,133345,133634,133990,9000,7465,4715,4804,5141,5300,0,185353,189879,181577,128541,128493,128690,978958,0,36425,489.47900000000004
297,120000,2,2,1,29,-1,-1,-1,-1,-1,-1,1686,657,2179,1423,0,1820,657,2319,1423,0,1820,2496,0,1029,-1662,756,1423,-1820,-676,7765,-6,8715,6.470833333333334
298,210000,2,2,1,36,0,0,0,0,0,0,143225,142996,144415,148190,147993,131629,6483,5082,6000,5900,4544,4700,0,136742,137914,138415,142290,143449,126929,858448,0,32709,408.7847619047619
299,280000,2,1,1,36,0,0,0,0,0,0,58983,60788,63225,29701,30172,30771,2755,3463,1300,1100,1100,2000,0,56228,57325,61925,28601,29072,28771,273640,0,11718,97.72857142857143
300,300000,1,1,2,34,1,-2,-1,0,-1,-1,0,0,13001,12601,19595,203,0,13001,0,19595,203,0,1,0,-13001,13001,-6994,19392,203,45400,-4,32799,15.133333333333333
301,100000,1,2,2,37,0,0,0,0,0,0,99209,98222,67185,66926,66796,64513,3490,2332,2314,2365,2497,2305,0,95719,95890,64871,64561,64299,62208,462851,0,15303,462.85100000000006
302,440000,2,1,2,36,-2,-2,-2,-2,-2,-2,0,0,0,0,0,0,0,0,0,0,162000,0,0,0,0,0,0,-162000,0,0,-12,162000,0.0
303,50000,2,3,1,40,0,0,0,0,0,0,49941,51213,12104,12898,13687,14458,2400,1206,1000,1000,1000,1000,0,47541,50007,11104,11898,12687,13458,154301,0,7606,308.602
304,20000,2,1,2,25,0,0,2,0,0,0,11968,14564,27820,15824,15761,12510,2800,0,4000,1700,1000,2000,1,9168,14564,23820,14124,14761,10510,98447,2,11500,492.23499999999996
305,200000,2,1,2,27,-1,-1,-1,0,0,0,871,665,960,4242,4084,7414,665,960,3908,1014,3500,2880,0,206,-295,-2948,3228,584,4534,18236,-3,12927,9.118
306,110000,2,2,2,26,-2,-2,-2,-2,-2,-2,432,3220,5704,1256,1848,400,3220,5904,0,3000,0,0,0,-2788,-2684,5704,-1744,1848,400,12860,-12,12124,11.690909090909091
307,500000,2,2,1,36,-1,-1,-1,-1,-1,-1,10483,23956,0,8500,4590,0,23962,0,8500,4590,0,0,0,-13479,23956,-8500,3910,4590,0,47529,-6,37052,9.5058
308,300000,2,2,1,27,1,-1,-1,-2,-2,-2,0,5215,0,0,0,0,5215,0,0,0,0,0,0,-5215,5215,0,0,0,0,5215,-7,5215,1.7383333333333333
309,30000,1,3,1,55,2,2,2,3,3,4,9720,10613,11339,12841,13836,14514,1200,1200,2000,1500,1500,1500,1,8520,9413,9339,11341,12336,13014,72863,16,8900,242.87666666666667
310,60000,2,1,2,27,-1,-1,-1,-1,-1,-1,20847,13801,14366,4889,273,11736,13809,14583,4889,273,13557,0,0,7038,-782,9477,4616,-13284,11736,65912,-6,47111,109.85333333333334
311,400000,2,2,1,38,-1,0,-1,-1,0,-1,3697,3600,1354,5322,5103,2077,1000,1354,5322,6,2386,9085,0,2697,2246,-3968,5316,2717,-7008,21153,-4,19153,5.28825
312,180000,2,2,1,34,0,0,0,0,0,0,143301,146333,147042,127814,130331,132845,7000,5000,5000,4900,5000,5100,0,136301,141333,142042,122914,125331,127745,827666,0,32000,459.81444444444446
313,20000,1,1,2,40,0,0,0,2,0,0,10934,13738,16567,10411,13057,14340,3000,3100,0,3000,1500,0,0,7934,10638,16567,7411,11557,14340,79047,2,10600,395.235
314,200000,2,3,1,49,-1,2,2,2,0,0,52439,51040,56205,54723,58657,59983,0,6000,0,5000,2286,3000,1,52439,45040,56205,49723,56371,56983,333047,5,16286,166.5235
315,100000,1,1,2,27,0,0,0,0,0,0,55734,52557,33415,28776,17580,6441,1631,1286,200,645,909,200,0,54103,51271,33215,28131,16671,6241,194503,0,4871,194.50300000000001
316,60000,1,2,2,23,0,0,0,0,0,0,49507,33282,34312,17277,17808,19346,1970,2000,618,809,2000,616,1,47537,31282,33694,16468,15808,18730,171532,0,8013,285.88666666666666
317,110000,2,2,2,36,0,0,0,0,0,0,47819,48947,50330,50894,52175,53652,2200,2500,2000,2100,2500,2200,0,45619,46447,48330,48794,49675,51452,303817,0,13500,276.1972727272728
318,260000,2,3,1,53,1,-1,-1,-2,-2,-1,0,165,526,452,397,485,165,526,452,397,485,459,0,-165,-361,74,55,-88,26,2025,-6,2484,0.7788461538461539
319,50000,2,3,1,46,3,2,2,0,0,0,48522,50955,29516,29742,29898,24883,3754,1,1070,1030,863,654,0,44768,50954,28446,28712,29035,24229,213516,7,7372,427.032
320,180000,1,2,2,29,1,-2,-2,-2,-2,-2,-2,-2,-2,-2,-2,-2,0,0,0,0,0,0,0,-2,-2,-2,-2,-2,-2,-12,-9,0,-0.006666666666666667
321,110000,1,2,2,29,1,2,2,0,0,0,58362,56598,51908,48647,47862,47969,2500,0,2000,2000,1854,2000,1,55862,56598,49908,46647,46008,45969,311346,5,10354,283.04181818181814
322,340000,2,1,2,27,0,0,0,0,0,0,172180,180140,166281,155628,145645,103263,21105,5461,5000,5849,2732,50000,0,151075,174679,161281,149779,142913,53263,923137,0,90147,271.51088235294117
323,50000,1,2,2,24,-1,0,0,0,0,0,1399,2441,3865,7476,8384,8085,1070,1500,3666,2477,1306,1000,0,329,941,199,4999,7078,7085,31650,-1,11019,63.3
324,230000,2,2,1,28,0,0,0,-2,-1,-1,26361,18826,1100,2100,767,6173,1710,1100,1000,767,6173,1000,1,24651,17726,100,1333,-5406,5173,55327,-4,11750,24.05521739130435
325,360000,2,2,2,32,0,0,0,0,0,0,93029,94054,91834,95631,100123,100738,10000,7000,10000,10000,10000,10000,0,83029,87054,81834,85631,90123,90738,575409,0,57000,159.83583333333334
326,210000,1,2,2,43,1,-2,-1,0,0,0,0,0,38013,40555,45075,37056,0,38013,3000,5000,3000,3000,0,0,-38013,35013,35555,42075,34056,160699,-2,52013,76.52333333333333
327,220000,2,2,1,41,-1,2,2,-1,2,-1,650,650,325,950,475,325,325,0,950,0,325,325,1,325,650,-625,950,150,0,3375,3,1925,1.5340909090909092
328,60000,2,2,1,34,2,2,2,2,2,0,24898,27976,27233,30184,29566,30225,3800,0,3720,0,1300,1291,1,21098,27976,23513,30184,28266,28934,170082,10,10111,283.47
329,340000,1,2,1,55,-2,-1,-1,-2,-2,-2,50396,44665,8300,2190,24599,7416,44665,8321,2190,24599,7416,77195,0,5731,36344,6110,-22409,17183,-69779,137566,-10,164386,40.46058823529412
330,150000,1,1,1,40,2,2,2,2,2,2,99855,102586,100064,104975,107147,109428,5200,0,8100,4000,4200,4200,0,94655,102586,91964,100975,102947,105228,624055,12,25700,416.03666666666663
331,200000,2,2,1,37,1,-1,2,-1,-1,-1,-179,505,189,6773,23209,16893,1000,0,6900,24000,17000,2500,1,-1179,505,-6711,-17227,6209,14393,47390,-1,51400,23.695
332,130000,2,2,2,40,0,0,2,0,0,0,9559,12394,11883,9826,10167,12685,3000,0,500,500,2700,500,1,6559,12394,11383,9326,7467,12185,66514,2,7200,51.16461538461539
333,60000,2,1,2,28,1,2,0,0,0,0,10540,10232,11237,11427,20973,31857,0,1483,673,10000,11540,7000,0,10540,8749,10564,1427,9433,24857,96266,3,30696,160.44333333333333
334,400000,2,2,1,43,1,-2,-2,-2,-1,-1,0,0,0,0,1600,78388,0,0,0,1600,78388,0,0,0,0,0,-1600,-76788,78388,79988,-7,79988,19.997
335,20000,1,1,2,27,0,0,0,0,0,0,20571,19089,19658,19453,19108,18868,1323,1600,830,700,674,376,0,19248,17489,18828,18753,18434,18492,116747,0,5503,583.735
336,190000,2,1,2,28,0,0,0,0,0,0,143464,146943,151905,153538,156664,160361,5795,7408,5645,5753,6370,5865,0,137669,139535,146260,147785,150294,154496,912875,0,36836,480.4605263157895
337,260000,2,1,2,30,0,0,0,0,0,0,156882,160246,159988,158114,158762,159108,10000,8000,6000,7000,7000,6000,0,146882,152246,153988,151114,151762,153108,953100,0,44000,366.5769230769231
338,140000,2,2,2,31,-2,-2,-2,-2,-2,-2,390,0,0,0,0,0,0,0,0,0,0,0,0,390,0,0,0,0,0,390,-12,0,0.2785714285714286
339,50000,2,2,1,31,0,0,0,0,0,0,46512,47716,49675,30929,30078,29170,1974,4406,1061,1073,1046,1047,1,44538,43310,48614,29856,29032,28123,234080,0,10607,468.16
340,120000,2,1,2,34,-1,-1,0,-1,-1,-1,882,6531,6313,1100,1330,830,6900,5037,1100,1330,3800,2037,0,-6018,1494,5213,-230,-2470,-1207,16986,-5,20204,14.155000000000001
341,240000,2,2,2,30,-2,-2,-2,-2,-2,-2,92,92,92,0,92,0,92,92,0,92,0,1883,0,0,0,92,-92,92,-1883,368,-12,2159,0.15333333333333335
342,50000,1,2,2,36,0,0,0,0,-1,0,5916,6172,4123,680,978,978,1212,1200,0,978,0,0,0,4704,4972,4123,-298,978,978,18847,-1,3390,37.694
343,200000,2,1,2,29,-1,2,-1,-1,-1,2,2393,183,4847,20183,24815,24248,0,4872,20183,5000,0,1000,0,2393,-4689,-15336,15183,24815,23248,76669,0,31055,38.3345
344,180000,1,1,1,39,0,0,-1,0,0,-1,274731,281713,242063,122295,-1005,1005,11000,145000,26000,0,101005,1898,0,263731,136713,216063,122295,-102010,-893,920802,-2,284903,511.55666666666673
345,180000,2,1,2,26,0,0,0,0,0,0,145403,138232,130553,105894,108248,106517,5440,5051,3835,4106,4250,4028,0,139963,133181,126718,101788,103998,102489,734847,0,26710,408.24833333333333
346,160000,2,1,2,29,-1,-1,-2,-1,0,0,3097,-707,-2697,2303,6182,1654,0,0,5000,5000,1500,13000,0,3097,-707,-7697,-2697,4682,-11346,9832,-5,24500,6.145
347,100000,2,2,2,26,-1,-1,-1,0,0,0,1370,4192,4159,3542,1980,3980,4210,4159,1000,1080,2000,1525,0,-2840,33,3159,2462,-20,2455,19223,-3,13974,19.223000000000003
348,50000,2,2,2,29,0,0,0,0,0,0,47081,49316,50409,45545,39963,41145,3000,2000,2000,2000,2000,2000,1,44081,47316,48409,43545,37963,39145,273459,0,13000,546.918
349,140000,2,2,2,31,0,0,0,0,0,0,138119,137950,140254,139679,141748,142174,6600,6500,5100,5300,6000,5000,0,131519,131450,135154,134379,135748,137174,839924,0,34500,599.9457142857143
350,30000,2,2,2,26,0,0,0,0,0,0,17893,19012,20123,20222,20796,19844,1411,1522,621,795,715,1000,1,16482,17490,19502,19427,20081,18844,117890,0,6064,392.9666666666667
351,90000,1,1,2,26,0,0,-1,0,0,-1,39128,20473,1940,1940,0,23101,1541,4200,0,0,23101,3000,0,37587,16273,1940,1940,-23101,20101,86582,-2,31842,96.20222222222222
352,200000,1,1,1,36,1,-2,-1,-1,-2,-1,-14386,-13543,3432,-3684,0,1386,10118,47015,0,4000,100000,10000,0,-24504,-60558,3432,-7684,-100000,-8614,-26795,-6,171133,-13.3975
353,380000,1,1,2,30,1,-2,-2,-2,-2,-2,0,0,0,0,0,0,0,0,0,0,0,0,1,0,0,0,0,0,0,0,-9,0,0.0
354,80000,2,2,2,43,0,0,0,0,0,0,77057,78102,58501,51042,19036,19414,3177,2600,3000,1691,695,882,0,73880,75502,55501,49351,18341,18532,303152,0,12045,378.94
355,50000,1,3,1,58,2,2,2,0,0,2,15899,18720,18122,18530,19089,18856,3400,0,1000,1001,634,638,0,12499,18720,17122,17529,18455,18218,109216,8,6673,218.43200000000002
356,180000,1,2,1,45,-1,0,0,0,0,0,27679,28422,29650,29981,30419,31127,1481,2000,1100,1200,1500,1500,1,26198,26422,28550,28781,28919,29627,177278,-1,8781,98.48777777777778
357,240000,2,2,2,26,0,0,0,0,0,0,141315,128940,124226,113133,113966,103360,6349,5834,3870,4000,3825,3520,0,134966,123106,120356,109133,110141,99840,724940,0,27398,302.05833333333334
358,380000,1,2,2,34,0,0,0,0,0,0,194314,179206,193992,174675,171253,169121,9010,35000,5000,6000,5000,4400,0,185304,144206,188992,168675,166253,164721,1082561,0,64410,284.88447368421055
359,110000,2,4,2,24,0,0,0,0,0,0,83755,77431,79044,80631,82333,84462,3000,2900,2900,3000,3500,4000,0,80755,74531,76144,77631,78833,80462,487656,0,19300,443.32363636363635
360,260000,1,1,1,34,-1,-1,-1,-1,-1,-1,49657,291,51058,2351,34039,291,291,51058,35696,34039,291,291,0,49366,-50767,15362,-31688,33748,0,137687,-6,121666,52.95653846153846
361,500000,2,2,2,23,4,3,2,0,0,0,507726,509229,499936,505507,484612,419643,10000,0,14000,16500,16000,19000,1,497726,509229,485936,489007,468612,400643,2926653,9,75500,585.3306
362,320000,2,2,2,30,0,0,0,0,0,0,71305,71151,72029,72849,74374,74610,2589,2568,2570,2661,2781,2500,0,68716,68583,69459,70188,71593,72110,436318,0,15669,136.349375
363,50000,1,2,2,32,4,3,2,0,0,0,45734,44741,43562,44039,45008,25775,0,0,1262,1358,1275,1590,0,45734,44741,42300,42681,43733,24185,248859,9,5485,497.71799999999996
364,110000,1,1,1,40,1,-2,-1,0,-1,-1,0,0,2066,2000,216,216,0,2066,0,216,216,66,1,0,-2066,2066,1784,0,150,4498,-4,2564,4.089090909090909
365,230000,2,1,2,35,-2,-2,-2,-2,-2,-2,761,300,399,665,576,613,300,399,665,576,613,520,0,461,-99,-266,89,-37,93,3314,-12,3073,1.4408695652173913
366,330000,2,2,1,56,1,-1,-1,-2,-1,-1,-9,1520,1488,0,3965,8676,1529,1507,0,3965,8676,384,0,-1538,13,1488,-3965,-4711,8292,15640,-5,16061,4.739393939393939
367,50000,2,2,1,61,0,0,0,0,0,0,47166,49396,50476,23319,23171,24774,3000,2237,975,1000,2000,1039,0,44166,47159,49501,22319,21171,23735,218302,0,10251,436.604
368,10000,1,2,2,24,-1,2,2,2,0,0,2887,1923,2989,2813,2008,2132,0,1500,0,0,150,0,0,2887,423,2989,2813,1858,2132,14752,5,1650,147.52
369,300000,1,1,1,40,1,-2,-2,-2,-2,-2,0,0,0,0,0,0,0,0,0,0,0,0,0,0,0,0,0,0,0,0,-9,0,0.0
370,20000,2,2,1,32,3,2,0,0,0,0,20631,20010,19703,11084,10918,10985,0,1168,384,390,632,616,1,20631,18842,19319,10694,10286,10369,93331,5,3190,466.655
371,180000,1,2,1,36,2,2,-2,-2,-2,-2,83538,0,0,0,0,0,0,0,0,0,0,0,1,83538,0,0,0,0,0,83538,-4,0,46.410000000000004
372,160000,1,1,2,30,-1,-1,-1,-1,-1,-1,99,2977,15086,8578,13028,21712,2977,15086,9123,13028,29712,50000,0,-2878,-12109,5963,-4450,-16684,-28288,61480,-6,119926,38.425
373,90000,2,1,2,34,0,0,0,2,2,2,34302,35089,43449,42451,49718,48767,1640,9000,0,8000,0,2000,0,32662,26089,43449,34451,49718,46767,253776,6,20640,281.9733333333333
374,30000,1,3,3,54,0,0,0,0,0,0,22987,22298,22352,23221,24339,25943,2500,2000,1500,4000,2000,0,0,20487,20298,20852,19221,22339,25943,141140,0,12000,470.46666666666664
375,180000,1,1,1,46,0,0,0,0,0,0,173267,174590,175233,106288,28089,178719,8100,5299,3305,5040,160719,7000,0,165167,169291,171928,101248,-132630,171719,836186,0,189463,464.5477777777778
376,30000,1,3,1,58,0,0,0,0,0,0,19143,20168,21229,21495,21800,22437,1640,1700,915,800,1000,1961,0,17503,18468,20314,20695,20800,20476,126272,0,8016,420.9066666666667
377,30000,1,2,1,43,1,2,0,0,0,2,20518,19901,20905,21509,25183,24242,0,1342,946,4200,0,1000,0,20518,18559,19959,17309,25183,23242,132258,5,7488,440.86
378,140000,2,1,2,28,-1,0,0,-1,-1,-1,10833,14446,7609,4991,3400,3745,14000,3855,4991,3600,5500,4000,0,-3167,10591,2618,1391,-2100,-255,45024,-4,35946,32.16
379,210000,1,1,2,30,0,0,0,0,0,0,69937,71906,43308,44584,47842,49888,3500,3000,2000,4000,3000,10000,0,66437,68906,41308,40584,44842,39888,327465,0,25500,155.93571428571428
380,50000,1,2,2,31,0,0,0,0,0,0,20526,15129,15093,9577,11139,12487,2000,3000,327,3000,3000,5000,1,18526,12129,14766,6577,8139,7487,83951,0,16327,167.902
381,130000,2,2,2,29,0,0,0,0,0,0,89055,90780,70947,72367,73875,75355,4200,2575,2600,2674,2701,5750,0,84855,88205,68347,69693,71174,69605,472379,0,20500,363.36846153846153
382,50000,2,2,1,37,2,2,2,0,0,0,1894,3200,3381,3559,1948,2415,1500,400,200,500,500,400,1,394,2800,3181,3059,1448,2015,16397,6,3500,32.794000000000004
383,140000,1,3,1,36,0,0,0,0,0,0,100594,78372,91502,90859,88616,88450,3000,30000,4000,4000,3400,3300,0,97594,48372,87502,86859,85216,85150,538393,0,47700,384.56642857142856
384,170000,2,2,2,28,-1,0,0,2,0,0,2948,3848,5646,5464,5577,5889,1105,1903,0,296,500,95,1,1843,1945,5646,5168,5077,5794,29372,1,3899,17.27764705882353
385,80000,1,2,2,25,0,0,0,0,0,-2,22619,31429,27923,25280,0,0,10010,1209,579,0,0,6305,0,12609,30220,27344,25280,0,-6305,107251,-2,18103,134.06375
386,410000,2,5,1,42,0,0,0,0,0,0,338106,342904,344464,240865,234939,240176,15000,14000,9000,8500,9000,8300,0,323106,328904,335464,232365,225939,231876,1741454,0,63800,424.74487804878044
387,80000,2,1,2,29,1,-1,-1,-2,-2,-2,0,80000,0,0,0,0,80000,0,0,0,0,0,0,-80000,80000,0,0,0,0,80000,-7,80000,100.0
388,80000,1,3,1,73,-1,0,0,2,2,2,63144,65631,68875,70646,72870,75018,3500,4330,3500,3500,3500,5100,1,59644,61301,65375,67146,69370,69918,416184,5,23430,520.23
389,150000,1,2,1,43,0,0,0,0,0,0,153249,154049,156523,159653,162866,157759,7900,6500,5700,5700,5700,5334,0,145349,147549,150823,153953,157166,152425,944099,0,36834,629.3993333333334
390,260000,1,1,1,30,-1,-1,-1,0,0,-1,1131,291,582,291,0,291,291,582,0,0,130291,651,1,840,-291,582,291,-130291,-360,2586,-4,131815,0.9946153846153846
391,350000,1,1,1,38,1,-2,-2,-2,-2,-2,0,0,0,0,0,0,0,0,0,0,0,0,0,0,0,0,0,0,0,0,-9,0,0.0
392,280000,2,2,1,39,1,-1,0,0,0,0,-1312,35918,37297,37154,32581,33316,38621,2000,1130,922,1011,5000,1,-39933,33918,36167,36232,31570,28316,174954,0,48684,62.48357142857143
393,310000,1,2,1,44,0,0,0,0,0,0,103797,91989,87720,76218,72090,71620,4400,4013,3011,3000,3001,2653,0,99397,87976,84709,73218,69089,68967,503434,0,20078,162.39806451612904
394,140000,2,2,2,29,0,0,0,0,0,0,20110,17102,18862,19996,21214,21085,3000,3000,3000,3500,2000,2000,0,17110,14102,15862,16496,19214,19085,118369,0,16500,84.54928571428572
395,360000,1,1,1,51,-1,-1,-1,-2,-2,-2,38000,25000,0,0,0,0,25000,0,0,0,0,0,0,13000,25000,0,0,0,0,63000,-9,25000,17.5
396,140000,2,1,2,27,0,0,0,0,0,0,142428,144105,143952,142590,142650,142620,10000,10000,6000,6000,6000,5600,0,132428,134105,137952,136590,136650,137020,858345,0,43600,613.1035714285714
397,100000,1,1,2,38,0,0,0,0,0,0,40810,42653,42351,43011,43011,28947,2502,1200,860,0,579,0,0,38308,41453,41491,43011,42432,28947,240783,0,5141,240.78300000000002
398,50000,2,2,2,22,-2,-2,-2,-2,-2,-2,0,0,0,848,0,632,0,0,848,0,632,0,0,0,0,-848,848,-632,632,1480,-12,1480,2.96
399,210000,2,2,1,30,0,0,0,0,0,0,104701,106134,108423,91143,82733,74125,4002,5000,3500,3000,2700,5000,0,100699,101134,104923,88143,80033,69125,567259,0,23202,270.12333333333333
400,120000,2,2,2,25,2,2,2,2,2,2,120298,120822,109887,116313,119311,117167,4007,0,8272,5000,0,4400,0,116291,120822,101615,111313,119311,112767,703798,12,21679,586.4983333333333
401,240000,1,1,2,29,0,0,0,0,0,-1,156362,132280,99174,65372,28797,184922,5233,3289,2072,3018,184922,6100,0,151129,128991,97102,62354,-156125,178822,666907,-1,204634,277.8779166666667
402,60000,2,3,3,42,0,0,0,0,0,0,41322,29091,28097,28665,28768,29064,1488,1394,962,1500,2541,2000,0,39834,27697,27135,27165,26227,27064,185007,0,9885,308.345
403,150000,1,1,2,41,-1,-1,-1,-1,-1,2,1464,2084,384,0,2344,822,2091,384,0,2344,0,472,1,-627,1700,384,-2344,2344,350,7098,-3,5291,4.732
404,30000,1,2,1,48,0,0,0,0,0,0,27879,28870,27806,25142,25667,26179,1774,1710,1046,1079,1089,2244,0,26105,27160,26760,24063,24578,23935,161543,0,8942,538.4766666666667
405,160000,2,1,2,29,2,2,2,2,2,2,160432,163916,159676,166893,170098,153800,7500,0,11558,5800,0,5654,1,152932,163916,148118,161093,170098,148146,974815,12,30512,609.259375
406,200000,1,1,1,52,-2,-2,-2,-2,-2,-2,3858,2690,3410,0,0,82150,2690,3487,0,0,85900,396,0,1168,-797,3410,0,-85900,81754,92108,-12,92473,46.054
407,120000,2,2,1,25,0,0,0,-2,-2,-2,26476,21393,0,0,0,0,6000,0,0,0,0,0,0,20476,21393,0,0,0,0,47869,-6,6000,39.89083333333333
408,500000,1,1,1,37,1,2,0,0,0,0,507062,491956,430637,376657,356636,303510,325,15296,12137,12312,14113,10526,0,506737,476660,418500,364345,342523,292984,2466458,3,64709,493.29159999999996
409,320000,2,1,2,27,0,0,0,0,0,0,55607,62893,59001,61565,59508,66541,11404,8232,10450,9697,16477,11341,0,44203,54661,48551,51868,43031,55200,365115,0,67601,114.09843749999999
410,280000,1,1,2,31,0,0,0,0,0,0,168382,175646,180650,182672,168399,167983,10000,8000,6371,6217,5947,6288,0,158382,167646,174279,176455,162452,161695,1043732,0,42823,372.76142857142855
411,60000,2,1,2,23,1,2,2,2,2,2,29332,28577,30805,31601,32349,32965,0,2709,1600,1400,1300,1200,1,29332,25868,29205,30201,31049,31765,185629,11,8209,309.38166666666666
412,200000,2,1,1,38,-1,-1,-2,-1,-1,-2,190,0,0,367,-150,-150,0,0,367,150,0,0,0,190,0,-367,217,-150,-150,257,-8,517,0.1285
413,230000,2,1,1,32,1,-2,-1,-1,-1,-1,0,0,2809,4595,792,3404,0,2809,4606,792,3404,0,0,0,-2809,-1797,3803,-2612,3404,11600,-5,11611,5.043478260869565
414,230000,2,2,2,27,1,2,0,0,0,0,13668,12647,13135,10596,9218,5068,0,1064,423,313,1000,4641,1,13668,11583,12712,10283,8218,427,64332,3,7441,27.970434782608695
415,480000,2,3,1,41,-2,-2,-2,-2,-2,-2,14867,26665,199960,9033,19371,22593,26734,199982,9033,19371,22593,2000,0,-11867,-173317,190927,-10338,-3222,20593,292489,-12,279713,60.935208333333335
416,50000,2,3,1,35,-1,-1,-1,-2,-2,-2,22500,5000,0,0,0,0,5000,0,0,0,0,640,0,17500,5000,0,0,0,-640,27500,-9,5640,55.00000000000001
417,200000,2,1,2,31,-2,-2,-2,-2,-2,-2,7184,14845,1097,0,0,160,17507,1102,0,0,160,1103,0,-10323,13743,1097,0,-160,-943,23286,-12,19872,11.643
418,50000,2,1,2,30,0,0,0,0,0,2,14811,16262,17286,17895,19450,18990,2000,1600,1200,2000,0,1000,0,12811,14662,16086,15895,19450,17990,104694,2,7800,209.388
419,50000,1,2,1,48,0,0,0,0,0,0,44338,43048,35639,18753,19091,19548,3629,3332,2000,2000,2000,2500,0,40709,39716,33639,16753,17091,17048,180417,0,15461,360.834
420,260000,2,1,2,36,1,-2,-2,-2,-2,-2,0,0,0,0,0,0,0,0,0,0,0,0,1,0,0,0,0,0,0,0,-9,0,0.0
421,30000,1,1,2,24,2,0,0,0,0,2,25265,26354,27710,27959,30002,29371,1500,1800,1007,2500,0,1800,0,23765,24554,26703,25459,30002,27571,166661,4,8607,555.5366666666667
422,440000,2,1,2,29,0,0,0,0,0,0,169661,167199,158520,156977,157963,151936,8071,9021,7013,6013,6028,6010,0,161590,158178,151507,150964,151935,145926,962256,0,42156,218.69454545454548
423,230000,2,2,2,38,-1,-1,-1,-1,-1,-1,10237,2795,1350,371,2980,0,2795,1350,371,2980,0,2213,0,7442,1445,979,-2609,2980,-2213,17733,-6,9709,7.71
424,200000,1,2,1,38,2,2,2,0,0,0,104978,105924,102663,97090,98045,105253,4500,0,3500,3500,9000,0,1,100478,105924,99163,93590,89045,105253,613953,6,20500,306.9765
425,490000,2,2,1,30,0,0,0,0,0,0,192586,197967,201666,205798,196698,190306,10000,7143,7306,6303,6429,6000,0,182586,190824,194360,199495,190269,184306,1185021,0,43181,241.84102040816327
426,80000,2,2,1,32,-1,-1,-2,-2,-2,-2,11262,0,0,0,0,0,0,0,0,0,0,0,0,11262,0,0,0,0,0,11262,-10,0,14.0775
427,20000,2,3,2,49,2,2,2,2,0,0,9551,12081,13087,12583,15327,16414,3000,1500,0,3123,1500,1000,1,6551,10581,13087,9460,13827,15414,79043,8,10123,395.21500000000003
428,170000,2,1,2,31,-1,-1,-1,-1,0,-1,199,199,199,398,199,199,199,199,398,0,199,398,1,0,0,-199,398,0,-199,1393,-5,1393,0.8194117647058824
429,70000,1,1,2,27,0,0,0,0,0,0,70119,68536,66601,29401,28949,29795,3600,1646,600,28468,1327,1000,0,66519,66890,66001,933,27622,28795,293401,0,36641,419.14428571428573
430,210000,2,2,2,33,0,0,0,0,0,0,212601,177946,119362,117766,68791,66167,6000,4500,5000,3000,3000,3000,0,206601,173446,114362,114766,65791,63167,762633,0,24500,363.15857142857146
431,90000,2,2,2,25,0,0,0,0,0,0,91894,71732,73241,74424,76070,77648,3200,3300,3000,3001,3000,3100,0,88694,68432,70241,71423,73070,74548,465009,0,18601,516.6766666666666
432,390000,2,1,2,27,0,0,0,0,0,0,304867,299998,300426,292869,292885,281826,13007,10612,10041,11000,10512,7000,1,291860,289386,290385,281869,282373,274826,1772871,0,62172,454.5823076923077
433,110000,2,1,2,29,0,0,0,0,0,0,48123,49537,50422,50990,52014,53206,2500,2500,2000,2000,2057,2500,0,45623,47037,48422,48990,49957,50706,304292,0,13557,276.6290909090909
434,580000,2,1,1,36,0,0,0,0,0,0,159760,162189,166127,169365,168755,167964,6422,6565,5951,6006,5894,5946,0,153338,155624,160176,163359,162861,162018,994160,0,36784,171.40689655172415
435,360000,1,3,1,55,0,0,-1,-1,-1,-2,9210,8485,17231,1770,0,0,6015,17454,1775,0,0,0,0,3195,-8969,15456,1770,0,0,36696,-5,25244,10.193333333333333
436,270000,2,2,1,32,1,2,2,2,2,2,234752,233036,229286,217644,223690,221413,10000,8000,0,16000,8000,0,1,224752,225036,229286,201644,215690,221413,1359821,11,42000,503.6374074074074
437,60000,2,1,2,27,-1,-1,-2,-1,2,-1,14072,0,0,300,150,150,0,0,300,0,150,200,0,14072,0,-300,300,0,-50,14672,-4,650,24.453333333333333
438,110000,1,3,1,37,0,0,0,0,0,0,61807,62499,62162,60605,60272,60145,2300,2200,2300,2200,2300,2300,0,59507,60299,59862,58405,57972,57845,367490,0,13600,334.08181818181816
439,50000,2,1,1,25,0,0,0,0,0,0,51044,50231,46677,44982,21399,20859,2500,3008,1000,761,800,704,0,48544,47223,45677,44221,20599,20155,235192,0,8773,470.38399999999996
440,80000,2,1,2,23,0,0,0,0,0,0,77024,73281,57806,37642,46235,47110,3212,1600,956,40000,1800,1700,1,73812,71681,56850,-2358,44435,45410,339098,0,49268,423.87249999999995
441,50000,1,2,2,23,-1,-1,-1,-1,0,0,350,350,400,1695,12645,12584,350,400,1695,11300,485,2400,0,0,-50,-1295,-9605,12160,10184,28024,-4,16630,56.047999999999995
442,100000,1,1,2,32,0,0,0,0,2,2,83831,85586,87289,91451,93381,89522,4000,4037,6500,3500,0,3200,0,79831,81549,80789,87951,93381,86322,531060,4,21237,531.06
443,30000,2,1,2,26,1,-2,-1,-1,-1,-1,0,0,945,0,197,2995,0,945,0,197,2995,0,0,0,-945,945,-197,-2798,2995,4137,-5,4137,13.79
444,200000,2,1,2,27,0,0,0,0,0,0,122923,124653,126355,114881,117213,124793,5704,5930,4000,4003,10033,4400,0,117219,118723,122355,110878,107180,120393,730818,0,34070,365.409
445,240000,1,1,2,44,0,0,0,0,0,0,246135,231443,234557,200643,194410,198857,12026,9010,7400,8000,8000,7000,1,234109,222433,227157,192643,186410,191857,1306045,0,51436,544.1854166666667
446,220000,1,2,2,34,0,0,0,0,0,0,37304,33304,29254,24875,20329,15602,1600,1500,1100,1000,600,500,0,35704,31804,28154,23875,19729,15102,160668,0,6300,73.03090909090909
447,160000,2,1,2,28,0,0,0,0,0,0,146433,107604,89902,90983,82255,83988,4500,4400,3000,2400,2500,2500,0,141933,103204,86902,88583,79755,81488,601165,0,19300,375.72812500000003
448,180000,2,1,1,53,-1,-1,-1,0,0,-1,46122,1260,29366,5400,0,1599,1260,29366,54,0,1599,0,0,44862,-28106,29312,5400,-1599,1599,83747,-4,32279,46.52611111111111
449,200000,1,4,1,42,0,0,0,0,0,0,38564,38246,32253,30384,30900,0,5000,1485,1956,1500,0,2102,0,33564,36761,30297,28884,30900,-2102,170347,0,12043,85.1735
450,140000,2,3,1,30,0,0,0,2,0,0,96304,98007,82227,65000,60848,58880,4505,12906,0,2210,2300,5200,0,91799,85101,82227,62790,58548,53680,461266,2,27121,329.4757142857143
451,380000,1,1,1,51,1,-2,-2,-2,-2,-2,0,0,0,0,0,0,0,0,0,0,0,0,1,0,0,0,0,0,0,0,-9,0,0.0
452,600000,1,1,1,53,2,2,0,0,0,0,467150,458862,469703,447130,440982,434715,0,18000,16000,16000,21000,20000,1,467150,440862,453703,431130,419982,414715,2718542,4,91000,453.0903333333334
453,260000,1,2,2,37,0,0,0,-1,0,0,255691,262736,36638,122388,127402,131074,14000,5022,130000,7000,6000,6000,0,241691,257714,-93362,115388,121402,125074,935929,-1,168022,359.9726923076923
454,200000,2,1,2,26,0,0,-2,-2,-2,-2,156786,179,1443,1443,1443,871,179,1443,1443,1443,871,2015,0,156607,-1264,0,0,572,-1144,162165,-8,7394,81.0825
455,80000,1,2,2,42,0,0,0,0,0,0,78129,28202,78553,49340,48919,48443,2500,51432,1800,1800,1800,1700,0,75629,-23230,76753,47540,47119,46743,331586,0,61032,414.4825
456,40000,1,2,2,39,0,0,0,0,0,-1,40034,36549,17431,15031,10600,5315,2027,1207,301,212,5315,4987,0,38007,35342,17130,14819,5285,328,124960,-1,14049,312.40000000000003
457,130000,1,3,2,39,1,2,2,2,2,2,71034,69329,74175,72383,77217,75820,0,6000,0,6000,0,6000,0,71034,63329,74175,66383,77217,69820,439958,11,18000,338.42923076923074
458,50000,1,1,2,32,-1,0,0,0,0,-2,23974,24131,25326,25775,0,0,1800,1900,1300,0,0,0,0,22174,22231,24026,25775,0,0,99206,-3,5000,198.412
459,230000,2,2,1,41,-1,-1,-1,-1,-1,-1,819,18163,5473,8162,6985,9130,18163,5654,12887,6985,9130,6554,0,-17344,12509,-7414,1177,-2145,2576,48732,-6,59373,21.18782608695652
460,70000,1,2,1,48,0,0,0,0,0,-1,50927,39883,32017,17630,9730,6400,2100,1217,500,0,6400,4590,1,48827,38666,31517,17630,3330,1810,156587,-1,14807,223.69571428571427
461,180000,2,2,1,38,0,0,0,0,0,0,152510,151651,159019,123022,126075,126219,5657,10372,5000,5000,5000,5000,0,146853,141279,154019,118022,121075,121219,838496,0,36029,465.8311111111111
462,80000,2,2,1,36,-1,-1,-1,-1,-1,-1,1689,8638,5702,2980,1260,7868,8638,5723,2980,1260,7868,2198,0,-6949,2915,2722,1720,-6608,5670,28137,-6,28667,35.17125
463,290000,2,2,2,26,0,0,0,-1,-1,0,20807,99860,100000,3015,23473,1448,80000,3000,3015,23473,1148,4900,0,-59193,96860,96985,-20458,22325,-3452,248603,-2,115536,85.7251724137931
464,230000,2,1,2,28,0,0,0,0,0,0,30141,131255,110503,99283,97599,96116,120093,8034,3013,4010,5882,3000,0,-89952,123221,107490,95273,91717,93116,564897,0,144032,245.6073913043478
465,170000,2,3,3,56,1,-2,-1,-1,-2,-1,0,0,1991,0,0,150,0,1991,0,0,150,614,0,0,-1991,1991,0,-150,-464,2141,-6,2755,1.2594117647058822
466,230000,1,1,1,59,-1,0,0,0,0,0,208459,206331,203813,201331,198999,191671,7536,7277,7100,7120,6844,6945,1,200923,199054,196713,194211,192155,184726,1210604,-1,42822,526.3495652173913
467,220000,1,1,2,38,0,0,0,0,0,0,212795,211043,212759,218541,167743,165300,8909,7500,9000,6729,6000,7009,1,203886,203543,203759,211812,161743,158291,1188181,0,45147,540.0822727272728
468,230000,1,2,2,32,0,0,0,0,0,0,28114,28006,25000,22046,19860,19831,1610,1224,655,627,620,500,0,26504,26782,24345,21419,19240,19331,142857,0,5236,62.111739130434785
469,500000,1,2,1,38,0,0,0,-1,0,0,59372,49677,49515,42568,48268,51481,10026,7241,50091,25000,5078,2132,0,49346,42436,-576,17568,43190,49349,300881,-1,99568,60.1762
470,90000,2,1,1,41,-1,-1,-1,-1,-1,-1,6160,3274,6190,307,2870,670,3276,6246,307,2870,670,1362,0,2884,-2972,5883,-2563,2200,-692,19471,-6,14731,21.634444444444444
471,390000,2,3,2,35,0,0,0,0,0,0,355215,363325,373181,252195,257496,263018,13802,16525,8893,9229,10000,9435,1,341413,346800,364288,242966,247496,253583,1864430,0,67884,478.05897435897435
472,400000,2,2,2,41,0,0,0,0,0,0,366193,372700,375948,195991,152127,155182,14020,13595,6243,6007,6061,6012,0,352173,359105,369705,189984,146066,149170,1618141,0,51938,404.53525
473,180000,1,2,1,34,-1,-1,-1,-1,-1,-1,2927,2790,1140,2144,1180,1382,2790,1140,2144,1180,1382,2440,0,137,1650,-1004,964,-202,-1058,11563,-6,11076,6.4238888888888885
474,60000,1,3,1,38,1,2,2,0,0,2,29295,30321,31018,32193,34213,35002,1800,1500,2000,2700,1500,0,0,27495,28821,29018,29493,32713,35002,192042,7,9500,320.07
475,120000,2,2,1,32,-1,-1,-1,-1,-1,-1,4158,2682,0,6440,0,5930,2682,0,6440,0,5930,5120,0,1476,2682,-6440,6440,-5930,810,19210,-6,20172,16.008333333333333
476,60000,2,2,2,29,0,0,0,0,0,0,27199,28358,28937,29614,30391,23159,1900,1400,1000,1100,1000,420,0,25299,26958,27937,28514,29391,22739,167658,0,6820,279.42999999999995
477,50000,1,1,2,44,0,0,0,0,0,0,50893,28527,29241,28513,29106,29638,1800,1500,1200,1203,1166,1000,0,49093,27027,28041,27310,27940,28638,195918,0,7869,391.836
478,70000,2,2,1,37,0,0,0,2,0,0,66759,68200,72972,71248,50610,50809,2518,5950,0,1782,1985,2700,0,64241,62250,72972,69466,48625,48109,380598,2,14935,543.7114285714285
479,500000,2,1,1,38,-1,2,-1,-1,-1,0,600,300,501,300,600,450,0,501,300,600,300,600,0,600,-201,201,-300,300,-150,2751,-2,2301,0.5502
480,200000,1,1,2,31,-2,-2,-2,-2,-2,-2,0,0,0,0,0,0,0,0,0,0,0,0,0,0,0,0,0,0,0,0,-12,0,0.0
481,250000,2,2,1,40,0,0,0,0,-1,2,44930,137101,90801,0,1069,919,120041,4435,0,1069,0,67619,0,-75111,132666,90801,-1069,1069,-66700,274820,1,193164,109.928
482,140000,1,2,2,26,0,0,2,2,2,2,131367,146193,140202,144035,140419,130271,17000,0,11400,550,5300,5400,1,114367,146193,128802,143485,135119,124871,832487,8,39650,594.6335714285715
483,70000,2,2,2,28,0,0,0,0,-1,2,41264,41799,37887,37876,6736,4162,2112,1200,758,6736,0,0,0,39152,40599,37129,31140,6736,4162,169724,1,10806,242.46285714285713
484,90000,1,3,1,48,1,2,2,2,2,2,77604,73317,71334,67009,63228,59378,1700,4000,1600,1600,1500,4086,0,75904,69317,69734,65409,61728,55292,411870,11,14486,457.6333333333333
485,100000,2,2,1,43,-1,-1,-1,-1,-1,-1,2491,1709,574,556,2306,2562,1709,574,556,2306,2562,2111,0,782,1135,18,-1750,-256,451,10198,-6,9818,10.198
486,190000,1,2,1,31,0,0,0,0,0,0,177554,180633,172914,130139,115494,117465,7600,6303,4137,3502,4027,3517,0,169954,174330,168777,126637,111467,113948,894199,0,29086,470.63105263157894
487,230000,2,1,1,42,-1,-1,-1,-1,-1,-1,6865,15111,13165,0,10500,6992,15111,13165,0,10500,6992,0,0,-8246,1946,13165,-10500,3508,6992,52633,-6,45768,22.88391304347826
488,320000,1,2,1,39,0,0,0,0,0,0,93768,91523,91579,91193,92837,95323,3317,3506,4218,5000,6080,938,0,90451,88017,87361,86193,86757,94385,556223,0,23059,173.81968750000001
489,220000,2,2,1,36,-1,-1,-1,0,-1,-1,396,1648,792,396,396,396,1648,792,0,396,396,792,1,-1252,856,792,0,0,-396,4024,-5,4024,1.829090909090909
490,260000,2,1,1,34,-1,-1,-1,-1,-1,-1,16426,6088,4663,3885,4414,2514,6277,4663,4140,4414,2646,7725,0,10149,1425,523,-529,1768,-5211,37990,-6,29865,14.611538461538462
491,90000,2,2,2,32,-2,-2,-2,-2,-2,-2,573,0,0,0,0,0,157,0,0,0,0,0,0,416,0,0,0,0,0,573,-12,157,0.6366666666666666
492,30000,2,2,1,43,2,2,2,2,2,0,28703,26622,24022,24368,20859,19633,1300,2,1608,0,900,800,0,27403,26620,22414,24368,19959,18833,144207,10,4610,480.69
493,260000,1,2,2,30,0,0,0,2,0,0,98560,100980,222102,108724,68500,69174,4000,11900,207,2003,2003,2003,0,94560,89080,221895,106721,66497,67171,668040,2,22116,256.9384615384616
494,170000,2,2,2,28,0,0,-1,-1,-2,-2,28304,17616,308,0,0,0,4000,308,0,0,0,0,0,24304,17308,308,0,0,0,46228,-6,4308,27.192941176470587
495,80000,2,1,1,28,0,0,0,0,0,0,8574,9434,10038,10040,10400,10490,1203,1047,248,408,294,276,1,7371,8387,9790,9632,10106,10214,58976,0,3476,73.72
496,50000,1,1,1,41,-1,-1,-1,-1,-1,-1,508,672,226,390,220,320,1000,390,1000,220,640,1000,0,-492,282,-774,170,-420,-680,2336,-6,4250,4.672
497,200000,2,3,2,47,0,0,0,0,0,0,203183,202961,194449,196814,200526,198717,7521,7000,7000,7128,8000,7100,0,195662,195961,187449,189686,192526,191617,1196650,0,43749,598.325
498,20000,1,2,2,23,0,0,2,0,0,0,16440,20417,18333,18848,30190,19664,7403,0,820,1025,1113,104,0,9037,20417,17513,17823,29077,19560,123892,2,10465,619.46
499,250000,2,1,1,49,-1,-1,-2,-1,-1,-1,66,0,0,120,-6,1639,0,0,120,6,1645,0,0,66,0,-120,114,-1651,1639,1819,-7,1771,0.7276
500,20000,1,1,1,38,0,0,0,2,2,0,15912,17272,20565,20705,20255,19933,1623,3916,750,0,800,850,0,14289,13356,19815,20705,19455,19083,114642,4,7939,573.21
501,30000,2,2,1,38,0,0,0,0,2,2,20344,21705,22537,24161,25128,24576,2000,1500,2000,1500,0,1200,0,18344,20205,20537,22661,25128,23376,138451,4,8200,461.5033333333334
502,90000,2,2,1,35,1,2,2,2,2,2,23132,22474,28067,27320,31199,30548,0,6000,0,4500,0,2000,0,23132,16474,28067,22820,31199,28548,162740,11,12500,180.82222222222222
503,230000,2,6,2,46,0,0,0,0,0,0,221590,227397,230302,186635,189896,193351,10000,9000,8000,8000,7500,7000,0,211590,218397,222302,178635,182396,186351,1249171,0,49500,543.1178260869565
504,130000,2,1,1,33,0,0,0,0,0,0,19161,20544,22704,22304,22304,0,2000,3000,0,0,0,0,1,17161,17544,22704,22304,22304,0,107017,0,5000,82.32076923076923
505,30000,1,6,1,53,-2,-2,-2,-2,-2,-2,0,0,0,0,0,0,0,0,0,0,0,0,0,0,0,0,0,0,0,0,-12,0,0.0
506,160000,1,1,2,35,-1,-1,-1,-1,-1,-1,396,396,396,0,792,1220,396,396,0,793,1220,0,0,0,0,396,-793,-428,1220,3200,-6,2805,2.0
507,500000,2,2,2,43,-1,-1,-1,0,0,-1,3959,0,285138,249445,222831,200,0,285138,4989,100,200,528666,0,3959,-285138,280149,249345,222631,-528466,761573,-4,819093,152.3146
508,180000,2,2,2,28,0,0,0,0,0,2,42238,38741,36696,35813,37893,34661,2500,2000,1128,2500,0,2000,0,39738,36741,35568,33313,37893,32661,226042,2,10128,125.57888888888888
509,80000,2,2,1,30,0,0,0,0,0,2,21507,13207,13997,10914,10685,5515,1700,1400,200,1000,0,500,0,19807,11807,13797,9914,10685,5015,75825,2,4800,94.78125
510,120000,1,1,2,26,-1,-1,-2,-1,-1,-2,884,0,0,10446,0,0,0,0,10446,0,0,0,0,884,0,-10446,10446,0,0,11330,-8,10446,9.441666666666666
511,130000,1,2,1,31,-1,-1,-1,-1,-1,2,1261,1261,1261,1411,930,390,1261,1261,1411,930,0,780,0,0,0,-150,481,930,-390,6514,-3,5643,5.01076923076923
512,120000,2,2,2,35,-1,-1,-1,-1,-1,-1,240,240,240,240,240,240,240,240,240,240,240,240,1,0,0,0,0,0,0,1440,-6,1440,1.2
513,360000,1,1,2,28,-1,-1,-1,-1,-1,-1,20223,52962,3978,1743,2828,50537,53228,3997,1750,2853,51041,3219,0,-33005,48965,2228,-1110,-48213,47318,132271,-6,116088,36.74194444444445
514,50000,1,2,2,23,2,2,2,2,2,2,29509,30741,31438,31924,32566,33081,2000,1500,1300,1300,1200,1500,1,27509,29241,30138,30624,31366,31581,189259,12,8800,378.518
515,20000,2,2,2,23,0,0,2,0,0,0,18355,20259,19534,16467,15746,13246,2900,10,577,430,1017,4,0,15455,20249,18957,16037,14729,13242,103607,2,4938,518.035
516,100000,1,3,1,56,0,0,-1,0,0,0,94265,53376,85787,78762,79529,80335,2385,88678,2169,2634,3132,732,0,91880,-35302,83618,76128,76397,79603,472054,-1,99730,472.054
517,70000,1,3,1,32,0,0,0,0,0,0,68739,67629,69188,68392,69884,71284,3060,3300,2610,2750,2750,5500,0,65679,64329,66578,65642,67134,65784,415116,0,19970,593.0228571428572
518,50000,1,2,1,47,0,0,0,0,0,0,13917,16695,21320,18614,19003,19439,3000,5000,2000,618,679,500,0,10917,11695,19320,17996,18324,18939,108988,0,11797,217.976
519,10000,2,2,2,22,1,2,0,0,0,0,10250,8558,10525,10050,9903,9984,0,2126,390,328,476,1287,0,10250,6432,10135,9722,9427,8697,59270,3,4607,592.6999999999999
520,290000,2,1,1,34,0,0,0,0,0,0,93844,97708,103066,104864,110151,115297,6000,7000,5000,7000,7000,7000,0,87844,90708,98066,97864,103151,108297,624930,0,39000,215.4931034482759
521,30000,2,1,1,31,0,0,0,0,0,0,16496,17522,18531,18744,19291,19818,1597,1606,819,1000,1000,1623,0,14899,15916,17712,17744,18291,18195,110402,0,7645,368.00666666666666
522,410000,2,2,2,27,1,-1,0,0,0,0,-58,32991,36465,44310,62408,61420,33049,16000,8700,18775,15000,5350,0,-33107,16991,27765,25535,47408,56070,237536,0,96874,57.93560975609756
523,360000,1,1,2,28,-1,-1,-1,0,0,-1,1210,820,64644,125984,106584,125557,390,75720,62520,17000,132200,167000,1,820,-74900,2124,108984,-25616,-41443,424799,-4,454830,117.99972222222222
524,140000,2,2,1,42,0,0,0,0,0,0,111496,112133,69529,70804,70781,66735,6022,3021,5012,5112,3000,5000,1,105474,109112,64517,65692,67781,61735,501478,0,27167,358.1985714285714
525,210000,2,1,2,32,0,0,0,0,0,0,67374,69489,70937,71761,73505,74827,3200,3200,2600,2900,2700,3000,0,64174,66289,68337,68861,70805,71827,427893,0,17600,203.7585714285714
526,220000,2,2,2,27,-1,-1,-1,-1,-1,-1,1692,13250,433,1831,0,2891,13250,433,1831,0,2891,153504,0,-11558,12817,-1398,1831,-2891,-150613,20097,-6,171909,9.135
527,20000,1,2,2,27,1,2,0,0,0,2,18649,18066,19040,19446,20759,20241,0,1594,1000,1606,0,300,0,18649,16472,18040,17840,20759,19941,116201,5,4500,581.005
528,620000,2,2,1,45,2,2,0,0,0,0,160837,156839,160440,163781,167159,170894,0,6200,6000,6000,6500,6000,1,160837,150639,154440,157781,160659,164894,979950,4,30700,158.05645161290323
529,360000,1,1,2,26,1,-2,-2,-2,-1,-1,-8,-8,-8,-8,1677,2600,0,0,0,1685,2613,0,0,-8,-8,-8,-1693,-936,2600,4245,-7,4298,1.1791666666666667
530,20000,2,2,2,21,-1,-1,2,2,-1,-1,18763,14410,13771,362,5308,0,14410,0,28,22073,0,0,0,4353,14410,13743,-21711,5308,0,52614,0,36511,263.07
531,50000,1,2,2,23,0,0,0,0,0,0,34549,18552,19334,18165,19322,19575,2836,1200,13000,1500,9000,1000,0,31713,17352,6334,16665,10322,18575,129497,0,28536,258.99399999999997
532,50000,1,2,3,30,0,0,0,0,0,0,97538,49187,17518,17710,18079,18302,2454,1588,780,803,673,637,0,95084,47599,16738,16907,17406,17665,218334,0,6935,436.66799999999995
533,10000,1,2,2,46,0,0,2,2,2,0,4073,6394,6143,6908,6652,6785,2400,0,871,0,244,251,1,1673,6394,5272,6908,6408,6534,36955,6,3766,369.55
534,100000,2,3,1,50,2,0,0,3,3,2,53849,55030,61574,62470,61198,62524,2050,7500,2500,0,2500,2500,1,51799,47530,59074,62470,58698,60024,356645,10,17050,356.64500000000004
535,50000,1,1,2,26,-2,-2,-2,-2,-2,-2,2411,3059,2333,1800,1620,0,3068,2440,1807,2204,0,0,0,-657,619,526,-404,1620,0,11223,-12,9519,22.445999999999998
536,60000,1,2,2,25,-1,-1,0,-1,-1,0,480,1675,3630,578,4825,6200,1675,2500,578,4825,2000,2435,0,-1195,-825,3052,-4247,2825,3765,17388,-4,14013,28.98
537,440000,2,1,2,35,0,0,0,0,0,0,330759,337794,274075,252584,216547,179221,13100,11000,10000,9000,7100,5500,0,317659,326794,264075,243584,209447,173721,1590980,0,55700,361.58636363636367
538,120000,1,2,1,44,0,0,0,0,0,0,92007,87939,82094,59105,53442,46775,5417,2847,2066,1919,2200,0,0,86590,85092,80028,57186,51242,46775,421362,0,14449,351.135
539,50000,2,1,2,52,0,0,0,-2,-1,-1,3257,4166,0,0,318,0,1000,0,0,318,0,0,0,2257,4166,0,-318,318,0,7741,-4,1318,15.482000000000001
540,110000,2,2,1,40,1,2,2,2,2,2,92638,90905,95768,97004,99005,101213,600,7300,3700,3700,4000,3800,0,92038,83605,92068,93304,95005,97413,576533,11,23100,524.1209090909091
541,200000,2,1,2,38,-1,-1,-2,-2,-1,-1,399,0,0,0,218,270,0,0,0,218,270,317,0,399,0,0,-218,-52,-47,887,-8,805,0.44349999999999995
542,150000,2,1,2,28,1,-2,-2,-2,-2,-1,0,0,0,0,0,318,0,0,0,0,318,0,0,0,0,0,0,-318,318,318,-8,318,0.212
543,30000,2,2,1,36,2,3,2,2,0,0,28778,28039,28286,27533,28189,28805,0,1000,0,1100,1100,1500,1,28778,27039,28286,26433,27089,27305,169630,9,4700,565.4333333333334
544,100000,2,1,2,24,0,0,0,0,-1,-1,30092,30486,30178,29735,14718,29427,1553,5000,87,14761,29514,330,0,28539,25486,30091,14974,-14796,29097,164636,-2,51245,164.636
545,360000,2,1,1,34,-1,0,0,-1,0,-1,12339,10138,23912,9785,166,2142,10000,13912,9785,0,2142,4230,0,2339,-3774,14127,9785,-1976,-2088,58482,-3,40069,16.245
546,390000,2,1,2,31,0,0,0,0,0,0,50620,43220,44237,46495,47751,51941,5000,3000,3000,2000,5000,5000,0,45620,40220,41237,44495,42751,46941,284264,0,23000,72.88820512820513
547,220000,2,1,1,41,1,-2,-2,-2,-2,-2,-65,-65,-65,-65,-65,-200,0,0,0,0,0,0,1,-65,-65,-65,-65,-65,-200,-525,-9,0,-0.23863636363636365
548,160000,2,2,2,25,-2,-2,-2,-2,-2,-2,0,0,0,0,0,0,0,0,0,0,0,0,0,0,0,0,0,0,0,0,-12,0,0.0
549,230000,2,1,2,28,-1,-1,0,0,0,0,2403,7357,9752,12608,10797,20539,7357,2566,3000,1000,10000,2000,0,-4954,4791,6752,11608,797,18539,63456,-2,25923,27.589565217391304
550,120000,1,1,2,27,0,0,0,0,0,0,52437,50473,45087,35424,31760,31214,5024,5000,5000,4000,5000,3500,0,47413,45473,40087,31424,26760,27714,246395,0,27524,205.32916666666665
551,100000,1,3,1,52,0,0,2,2,2,0,4657,6068,6418,6781,6144,7638,1500,1000,1000,0,2000,2000,1,3157,5068,5418,6781,4144,5638,37706,6,7500,37.706
552,190000,2,1,2,41,-1,-1,-1,-1,-1,-1,28204,0,16500,0,26854,554,0,16500,0,26854,500,0,1,28204,-16500,16500,-26854,26354,554,72112,-6,43854,37.95368421052632
553,50000,1,1,1,56,0,0,0,0,0,0,50715,51073,28185,28842,30399,29977,2500,1500,1100,2000,1500,1017,1,48215,49573,27085,26842,28899,28960,219191,0,9617,438.382
554,240000,2,1,1,42,1,-1,-1,-2,-2,-2,0,6370,0,0,0,0,6370,0,0,0,0,0,0,-6370,6370,0,0,0,0,6370,-7,6370,2.654166666666667
555,40000,2,2,2,24,-2,-2,-2,-2,-2,-2,35285,36714,37356,38184,38724,37255,2000,1600,1401,1607,1800,1751,0,33285,35114,35955,36577,36924,35504,223518,-12,10159,558.7950000000001
556,630000,2,2,1,47,0,0,0,-1,-1,-2,37850,68187,1207,2632,8654,0,38187,1207,2632,8654,0,4981,0,-337,66980,-1425,-6022,8654,-4981,118530,-4,55661,18.814285714285713
557,160000,2,1,1,33,-2,-2,-2,-2,-2,-2,5233,5393,1824,350,150,199,5401,1829,350,150,199,1145,0,-168,3564,1474,200,-49,-946,13149,-12,9074,8.218125
558,110000,2,2,2,32,0,0,2,2,2,2,65299,74565,78516,79829,81603,83206,11000,5800,3200,3200,3100,3000,0,54299,68765,75316,76629,78503,80206,463018,8,29300,420.9254545454545
559,20000,1,2,2,29,0,0,0,-2,-2,-2,17208,18419,0,0,0,0,2055,0,0,0,0,0,0,15153,18419,0,0,0,0,35627,-6,2055,178.135
560,210000,2,3,1,53,0,0,0,0,0,0,57192,58472,59658,60466,61593,65163,2800,2753,2400,2255,4767,0,0,54392,55719,57258,58211,56826,65163,362544,0,14975,172.64
561,270000,1,1,2,34,-1,-1,0,-1,-1,-1,5780,12006,15736,6621,2457,14923,12006,5736,6621,2457,14923,1712,0,-6226,6270,9115,4164,-12466,13211,57523,-5,43455,21.304814814814815
562,360000,2,2,2,52,-2,-2,-2,-2,-2,-2,640,2113,-6,999,944,-3,2231,0,1005,948,0,789,0,-1591,2113,-1011,51,944,-792,4687,-12,4973,1.3019444444444446
563,60000,2,2,1,42,-1,-1,-1,-1,-1,-1,631,2790,1758,416,416,3640,2790,1758,416,416,3640,730,0,-2159,1032,1342,0,-3224,2910,9651,-6,9750,16.085
564,360000,1,2,2,38,-1,0,0,0,0,0,108351,111201,63146,63723,65108,66078,8005,8004,5000,5000,5000,105700,0,100346,103197,58146,58723,60108,-39622,477607,-1,136709,132.6686111111111
565,390000,2,1,2,45,2,2,2,-1,2,2,834,155,-1690,4240,3346,2698,1,1693,6940,7,1230,3,0,833,-1538,-8630,4233,2116,2695,9583,9,9874,2.4571794871794874
566,250000,2,3,2,35,-2,-2,-2,-2,-2,-2,7244,8472,1738,6706,2391,11082,8514,1751,6739,2403,11137,13407,0,-1270,6721,-5001,4303,-8746,-2325,37633,-12,43951,15.0532
567,90000,2,1,2,24,0,0,0,0,0,0,13141,14526,15482,18219,22737,23387,1600,1500,3000,5000,1020,764,1,11541,13026,12482,13219,21717,22623,107492,0,12884,119.43555555555557
568,360000,1,1,2,28,-1,-1,-1,-1,-1,-1,7071,401,3545,10540,10132,6220,1510,3575,10573,10155,6240,16071,0,5561,-3174,-7028,385,3892,-9851,37909,-6,48124,10.530277777777778
569,50000,1,3,2,26,0,0,0,0,0,0,35429,30626,30241,20284,19166,19567,1537,1947,800,1000,718,683,0,33892,28679,29441,19284,18448,18884,155313,0,6685,310.626
570,270000,2,1,1,40,0,0,0,-2,-2,-2,18751,5706,0,0,0,0,1000,0,0,0,0,0,0,17751,5706,0,0,0,0,24457,-6,1000,9.058148148148149
571,200000,2,1,2,29,1,-1,-1,-1,-1,-1,55788,8360,4897,5065,19468,0,8394,4927,5089,19561,0,125,0,47394,3433,-192,-14496,19468,-125,93578,-4,38096,46.788999999999994
572,50000,2,2,2,23,0,0,0,0,0,0,49809,50364,38429,18815,18305,19013,2040,2766,1690,1000,1000,1000,0,47769,47598,36739,17815,17305,18013,194735,0,9496,389.46999999999997
573,350000,1,1,2,33,-1,-1,-1,-2,-2,-1,10900,10478,-22,-22,-22,4532,10530,0,0,0,4554,0,0,370,10478,-22,-22,-4576,4532,25844,-8,15084,7.384
574,160000,2,2,2,60,-2,-1,-1,0,-1,-1,3128,5156,1089,489,3177,1009,5156,1089,0,3177,1009,0,1,-2028,4067,1089,-2688,2168,1009,14048,-6,10431,8.780000000000001
575,80000,2,3,1,49,-1,-1,-1,-1,-1,-1,3367,4641,2290,1459,6764,7601,4641,2290,1459,6764,7601,7990,0,-1274,2351,831,-5305,-837,-389,26122,-6,30745,32.6525
576,290000,1,1,1,53,2,0,0,0,0,0,279610,282024,282508,284660,255892,238266,13000,10200,10265,8803,8300,8546,1,266610,271824,272243,275857,247592,229720,1622960,2,59114,559.6413793103447
577,270000,2,1,2,28,-1,-1,-1,0,0,0,475,475,5691,37526,50565,48888,475,5691,34000,14000,8000,15000,0,0,-5216,-28309,23526,42565,33888,143620,-3,77166,53.19259259259259
578,80000,1,1,2,31,-1,-1,-1,-1,2,-1,5994,32223,8308,4082,538,4085,13647,8314,4082,0,4085,0,0,-7653,23909,4226,4082,-3547,4085,55230,-3,30128,69.0375
579,50000,1,2,2,36,0,0,0,0,0,0,5197,6015,6615,7131,6987,6980,1300,1100,1000,500,500,1000,0,3897,4915,5615,6631,6487,5980,38925,0,5400,77.85
580,30000,1,2,1,35,-2,-1,-1,-1,-1,-2,7797,2687,8762,3377,2000,0,2687,8765,3390,2040,0,0,0,5110,-6078,5372,1337,2000,0,24623,-8,16882,82.07666666666667
581,30000,1,2,2,28,1,-1,-1,-2,-2,-2,0,780,0,0,0,0,780,0,0,0,0,0,1,-780,780,0,0,0,0,780,-7,780,2.6
582,90000,1,2,2,33,-1,0,0,0,0,0,35785,29155,27485,29266,35598,38449,15155,5485,5263,8598,5449,6537,0,20630,23670,22222,20668,30149,31912,195738,-1,46487,217.48666666666665
583,160000,1,1,2,26,-1,-1,-1,-1,-1,-1,1433,3746,30258,1036,21572,9528,3757,30348,1044,21636,9556,6066,0,-2324,-26602,29214,-20600,12016,3462,67573,-6,72407,42.233125
584,80000,2,3,2,53,0,0,0,0,0,0,77766,77954,78512,60452,61556,54022,4000,2374,2007,2500,3000,2000,0,73766,75580,76505,57952,58556,52022,410262,0,15881,512.8275
585,50000,1,2,2,42,0,0,0,0,0,0,50300,50898,49111,48943,45775,0,2200,1600,1700,1700,0,0,0,48100,49298,47411,47243,45775,0,245027,0,7200,490.05400000000003
586,20000,2,1,2,25,0,0,0,0,0,2,14603,15661,16394,16723,18056,17618,1600,1300,600,1600,0,800,0,13003,14361,15794,15123,18056,16818,99055,2,5900,495.275
587,220000,1,1,1,43,1,-2,-2,-2,-2,-2,0,0,0,0,0,0,0,0,0,0,0,0,1,0,0,0,0,0,0,0,-9,0,0.0
588,210000,1,3,2,25,-1,-1,2,-1,-1,-1,8817,23634,21776,9631,1561,1990,23776,0,9631,1561,1990,7967,1,-14959,23634,12145,8070,-429,-5977,67409,-3,44925,32.09952380952381
589,130000,2,2,2,29,0,0,0,0,0,0,131575,130931,132969,45584,46516,47455,6700,6000,1291,1319,1336,1365,0,124875,124931,131678,44265,45180,46090,535030,0,18011,411.5615384615385
590,260000,2,2,1,31,-1,-1,0,0,-1,-1,5841,23194,62361,67057,17024,18659,23194,50000,11500,17024,18659,38923,0,-17353,-26806,50861,50033,-1635,-20264,194136,-4,159300,74.6676923076923
591,230000,2,1,1,30,0,0,0,-1,0,0,30341,25981,24092,65840,56538,51522,5000,5000,65840,2000,2000,10000,0,25341,20981,-41748,63840,54538,41522,254314,-1,89840,110.5713043478261
592,160000,1,1,2,34,0,0,0,0,0,0,83255,83912,85161,85715,86773,87526,4000,3924,3200,3300,3425,3013,0,79255,79988,81961,82415,83348,84513,512342,0,20862,320.21375
593,50000,1,1,1,35,0,0,0,0,0,0,34976,6018,13930,7106,6020,9011,1127,1074,215,249,4383,172,0,33849,4944,13715,6857,1637,8839,77061,0,7220,154.122
594,80000,1,2,1,32,0,0,0,0,0,0,48747,45955,44989,41358,42379,38052,2145,1844,2009,5017,2000,5002,0,46602,44111,42980,36341,40379,33050,261480,0,18017,326.85
595,110000,1,3,2,46,0,0,0,0,0,0,56700,57875,59044,59756,61004,62213,2681,2724,2287,2362,2374,2454,0,54019,55151,56757,57394,58630,59759,356592,0,14882,324.17454545454547
596,200000,1,1,1,43,0,0,0,0,0,0,144678,140804,136437,135253,134629,134309,5090,5014,5009,4844,5002,4902,0,139588,135790,131428,130409,129627,129407,826110,0,29861,413.05500000000006
597,360000,1,2,2,29,0,0,0,0,0,0,268112,263368,259969,255832,245462,250244,9429,8738,7017,7154,7073,7300,0,258683,254630,252952,248678,238389,242944,1542987,0,46711,428.6075
598,210000,2,3,2,31,1,-2,-2,-2,-2,-2,0,0,0,0,0,0,0,0,0,0,0,0,0,0,0,0,0,0,0,0,-9,0,0.0
599,80000,2,2,2,24,2,0,0,0,0,0,79243,75254,58683,58886,60035,57264,3249,3000,5000,2500,2300,2200,0,75994,72254,53683,56386,57735,55064,389365,2,18249,486.70625
600,300000,2,2,1,36,-1,-1,2,0,-1,-1,-475,5191,4606,2303,2768,65373,10000,0,0,2768,65373,10780,1,-10475,5191,4606,-465,-62605,54593,79766,-2,88921,26.588666666666665
601,310000,2,2,1,43,0,0,0,0,0,0,23396,24182,25135,25095,25356,25514,1426,1379,867,898,933,807,0,21970,22803,24268,24197,24423,24707,148678,0,6310,47.96064516129032
602,30000,1,3,1,59,-1,-1,-1,-1,-1,-1,390,390,390,390,390,1320,390,390,390,390,1320,0,1,0,0,0,0,-930,1320,3270,-6,2880,10.9
603,170000,1,1,1,53,0,0,0,0,0,0,17862,17927,18800,17647,18015,12930,1323,1196,544,563,629,361,0,16539,16731,18256,17084,17386,12569,103181,0,4616,60.69470588235294
604,140000,2,2,2,28,2,2,2,0,0,2,26450,28823,28171,28740,30454,29930,3007,0,924,2070,0,3000,0,23443,28823,27247,26670,30454,26930,172568,8,9001,123.26285714285714
605,180000,2,2,2,31,1,-2,-2,-2,-2,-2,0,0,0,0,0,0,0,0,0,0,0,1576,0,0,0,0,0,0,-1576,0,-9,1576,0.0
606,50000,1,1,2,34,1,2,2,2,2,2,22746,22099,24121,23437,25101,24549,0,2700,0,2200,0,1030,0,22746,19399,24121,21237,25101,23519,142053,11,5930,284.106
607,50000,2,2,1,36,0,0,0,0,0,-2,9214,10359,7350,7500,0,0,1351,1500,150,0,0,0,0,7863,8859,7200,7500,0,0,34423,-2,3001,68.84599999999999
608,110000,2,1,2,24,0,0,0,0,2,0,40882,35428,39680,44097,42543,33189,2000,5000,5000,0,2000,3000,0,38882,30428,34680,44097,40543,30189,235819,2,17000,214.38090909090909
609,450000,2,3,1,36,-2,-2,-2,-2,-2,-2,3996,9120,8528,0,6368,3000,9120,8528,0,6368,3000,3238,0,-5124,592,8528,-6368,3368,-238,31012,-12,30254,6.891555555555555
610,200000,2,2,1,34,-1,-1,-1,-1,-1,-1,390,390,390,561,390,390,390,390,561,390,390,390,0,0,0,-171,171,0,0,2511,-6,2511,1.2555
611,220000,1,1,2,43,0,0,-1,-1,-1,-1,44177,25736,19292,18900,13580,33150,1006,32906,18900,13580,33150,0,0,43171,-7170,392,5320,-19570,33150,154835,-4,99542,70.37954545454545
612,360000,2,1,2,29,0,0,-2,-2,-2,-1,3280,0,0,0,0,2650,0,0,0,0,2650,0,1,3280,0,0,0,-2650,2650,5930,-7,2650,1.6472222222222221
613,50000,1,2,1,37,0,0,0,0,0,0,48226,48727,46228,46755,43686,44573,2000,1684,1601,2000,2000,2000,0,46226,47043,44627,44755,41686,42573,278195,0,11285,556.39
614,40000,1,2,2,23,2,2,0,0,0,0,36650,29541,26190,26710,27274,29551,0,1435,955,993,2734,0,0,36650,28106,25235,25717,24540,29551,175916,4,6117,439.78999999999996
615,190000,2,2,1,37,1,2,2,2,2,2,115049,117856,119570,116284,123528,125478,6000,5000,0,9000,4000,5000,0,109049,112856,119570,107284,119528,120478,717765,11,29000,377.7710526315789
616,150000,1,1,2,33,0,0,0,0,0,0,21724,23168,23320,24085,24149,3323,2100,1200,965,64,509,8399,0,19624,21968,22355,24021,23640,-5076,119769,0,13237,79.84599999999999
617,200000,2,1,1,37,1,-2,-2,-2,-1,-1,0,0,0,0,595,0,0,0,0,595,0,2370,0,0,0,0,-595,595,-2370,595,-7,2965,0.29750000000000004
618,270000,2,2,1,56,0,0,0,0,0,0,137807,123769,104377,106651,109294,101151,5000,5000,3953,4500,4000,3900,0,132807,118769,100424,102151,105294,97251,683049,0,26353,252.9811111111111
619,60000,1,1,2,25,0,0,0,0,0,0,58839,53235,38533,39639,39619,39140,2018,1900,2000,1500,1900,2000,0,56821,51335,36533,38139,37719,37140,269005,0,11318,448.3416666666667
620,200000,2,2,1,39,0,0,0,0,0,0,80833,79100,70764,71629,70805,70718,3315,3088,2572,2559,2526,2620,0,77518,76012,68192,69070,68279,68098,443849,0,16680,221.9245
621,150000,2,2,1,39,0,0,0,0,0,0,36146,36184,37511,33080,30223,31561,3000,3000,3000,2500,2000,2000,0,33146,33184,34511,30580,28223,29561,204705,0,15500,136.47
622,180000,2,2,2,28,-1,-1,-1,-1,-1,-1,340,-120,420,460,460,610,0,1000,500,460,610,460,0,340,-1120,-80,0,-150,150,2170,-6,3030,1.2055555555555555
623,90000,2,1,2,27,0,0,-2,-2,-2,-2,7624,0,0,0,0,0,0,0,0,0,0,0,0,7624,0,0,0,0,0,7624,-8,0,8.471111111111112
624,360000,2,2,1,37,1,-2,-2,-2,-1,-1,0,0,0,0,166,541,0,0,0,166,543,4268,0,0,0,0,-166,-377,-3727,707,-7,4977,0.19638888888888886
625,90000,2,1,2,24,-1,-1,-2,-2,-2,-2,491,0,0,0,0,0,0,0,0,0,0,0,0,491,0,0,0,0,0,491,-10,0,0.5455555555555556
626,20000,2,2,2,24,0,0,0,0,2,0,13168,13888,14900,15916,15519,15829,1237,1249,1265,0,568,1327,0,11931,12639,13635,15916,14951,14502,89220,2,5646,446.1
627,70000,1,1,1,46,0,0,0,0,0,0,60040,55274,51766,51757,50013,49946,2600,1800,2000,3140,2000,1800,0,57440,53474,49766,48617,48013,48146,318796,0,13340,455.42285714285714
628,230000,1,1,1,39,-1,-1,-1,-1,-1,-1,660,660,660,660,660,660,660,660,660,660,660,660,0,0,0,0,0,0,0,3960,-6,3960,1.7217391304347827
629,30000,1,3,1,48,0,0,0,0,0,0,29434,28960,29022,29201,29553,29693,1465,2000,1033,1200,1055,530,0,27969,26960,27989,28001,28498,29163,175863,0,7283,586.21
630,200000,2,3,3,45,-1,-1,-1,-1,-1,-1,4430,7182,3855,3411,6788,9921,7193,3855,3411,6788,9921,5016,0,-2763,3327,444,-3377,-3133,4905,35587,-6,36184,17.7935
631,100000,1,3,2,49,-1,-1,-2,-2,-2,-2,1440,0,0,0,0,0,0,0,0,0,0,0,0,1440,0,0,0,0,0,1440,-10,0,1.44
632,50000,2,2,2,23,0,0,0,0,0,2,26795,28056,29284,30487,33831,33138,2000,2000,2000,4000,0,2000,0,24795,26056,27284,26487,33831,31138,181591,2,12000,363.18199999999996
633,20000,2,3,1,25,0,0,0,0,0,-2,16591,16442,6401,4300,1304,0,1155,1000,0,1304,0,0,0,15436,15442,6401,2996,1304,0,45038,-2,3459,225.19
634,210000,2,2,1,47,-2,-2,-2,-2,-2,-2,0,0,0,0,0,0,0,0,0,0,0,0,0,0,0,0,0,0,0,0,-12,0,0.0
635,110000,1,3,1,56,0,0,0,0,0,0,46486,35758,34323,30452,22628,23468,4086,1428,1318,2171,3198,4976,0,42400,34330,33005,28281,19430,18492,193115,0,17177,175.5590909090909
636,20000,2,3,1,44,-1,-1,-1,-1,-1,-2,550,228,0,228,0,0,228,0,228,0,0,0,0,322,228,-228,228,0,0,1006,-7,456,5.029999999999999
637,50000,2,3,1,49,0,0,0,0,0,0,5630,6629,5918,6918,6941,4756,1107,1000,1000,1500,2150,0,0,4523,5629,4918,5418,4791,4756,36792,0,6757,73.584
638,50000,1,2,1,41,0,0,0,0,0,0,21986,21520,20979,19894,18811,18805,1362,1294,682,680,694,618,0,20624,20226,20297,19214,18117,18187,121995,0,5330,243.99
639,400000,2,1,2,40,-1,-1,-1,-1,-1,0,60125,1981,4521,20472,76933,173599,1981,4521,20500,77000,100000,7700,0,58144,-2540,-15979,-56528,-23067,165899,337631,-5,211702,84.40775000000001
640,170000,1,2,2,31,0,0,0,0,0,0,56364,58132,59171,55888,53672,51461,3000,3000,2000,3000,3000,3000,0,53364,55132,57171,52888,50672,48461,334688,0,17000,196.87529411764706
641,280000,1,2,1,42,0,0,0,0,0,0,148363,148432,151310,141937,144990,147911,6900,6867,5500,5500,5500,5600,0,141463,141565,145810,136437,139490,142311,882943,0,35867,315.33678571428567
642,130000,2,3,1,28,0,0,0,0,-2,-2,100143,50456,50000,0,0,0,2500,1000,0,0,0,0,0,97643,49456,50000,0,0,0,200599,-4,3500,154.30692307692308
643,210000,2,2,2,32,0,0,0,0,0,0,46255,50486,54019,58091,61630,65576,5000,5000,5000,4500,5000,5000,0,41255,45486,49019,53591,56630,60576,336057,0,29500,160.02714285714285
644,370000,1,2,2,28,0,0,0,0,0,0,276436,239025,149128,48907,53025,51434,20000,13000,5000,10000,4000,6000,0,256436,226025,144128,38907,49025,45434,817955,0,58000,221.0689189189189
645,30000,2,2,1,31,0,0,2,0,0,0,29493,19433,18782,19006,19637,21251,3200,0,742,1000,2000,0,0,26293,19433,18040,18006,17637,21251,127602,2,6942,425.34000000000003
646,150000,1,3,2,39,1,-1,-1,-2,-2,-2,214450,147280,150000,0,-5000,0,5180,5000,0,0,5000,0,0,209270,142280,150000,0,-10000,0,506730,-7,15180,337.82
647,60000,1,3,1,31,2,0,0,-2,-2,-2,35369,35320,0,0,0,0,1027,0,0,0,0,0,1,34342,35320,0,0,0,0,70689,-4,1027,117.815
648,80000,2,2,2,24,0,0,0,0,0,0,77615,77303,66396,55639,56873,58390,3100,2586,2000,2500,3000,2500,0,74515,74717,64396,53139,53873,55890,392216,0,15686,490.27000000000004
649,280000,2,2,1,44,2,2,2,2,2,2,186149,181779,192189,195517,199250,195874,0,15000,8000,7000,0,15000,1,186149,166779,184189,188517,199250,180874,1150758,12,45000,410.98499999999996
650,20000,2,2,2,46,8,7,6,5,4,3,21075,20795,20206,19617,18737,18148,0,0,0,0,0,0,0,21075,20795,20206,19617,18737,18148,118578,33,0,592.89
651,270000,1,1,2,32,-2,-2,-2,-2,-2,-2,0,0,1100,300,-200,-200,0,1100,300,0,0,0,0,0,-1100,800,300,-200,-200,1000,-12,1400,0.3703703703703704
652,240000,2,2,2,26,0,0,-1,-1,-1,-1,14348,7500,7816,7500,7500,14497,1000,7816,7500,7500,14497,500,0,13348,-316,316,0,-6997,13997,59161,-4,38813,24.650416666666665
653,20000,2,1,2,22,0,0,0,0,0,0,20137,20179,18067,18666,19115,19547,1300,1301,900,900,900,1600,0,18837,18878,17167,17766,18215,17947,115711,0,6901,578.555
654,450000,2,1,1,42,1,-2,-2,-1,-1,-2,-200,-200,0,42000,0,0,0,200,42000,0,0,0,1,-200,-400,-42000,42000,0,0,41600,-7,42200,9.244444444444444
655,10000,1,2,2,33,0,0,0,0,0,0,8177,9131,9669,7624,8049,6857,2500,1145,1000,1000,1000,1500,0,5677,7986,8669,6624,7049,5357,49507,0,8145,495.07000000000005
656,280000,1,2,1,39,-2,-2,-2,-2,-2,-2,2082,3557,5623,5400,3866,3526,3597,5672,5427,3885,3543,3519,1,-1515,-2115,196,1515,323,7,24054,-12,25643,8.590714285714286
657,290000,2,3,2,27,0,0,0,0,-1,-1,13820,15614,16293,7760,2000,0,2000,1300,0,2000,1000,0,0,11820,14314,16293,5760,1000,0,55487,-2,6300,19.13344827586207
658,190000,2,1,2,28,0,0,0,0,0,0,46923,48666,49347,50386,43883,34412,2500,2000,3000,2000,2000,2000,1,44423,46666,46347,48386,41883,32412,273617,0,13500,144.00894736842105
659,80000,2,1,2,23,0,0,0,0,0,-1,53261,38091,19744,14556,0,1460,4500,2011,3105,0,1460,0,0,48761,36080,16639,14556,-1460,1460,127112,-1,11076,158.89
660,280000,2,2,2,28,-1,2,-1,-1,0,-1,427,298,1179,1714,2875,1047,0,1179,1714,1290,1047,1000,0,427,-881,-535,424,1828,47,7540,-2,6230,2.692857142857143
661,160000,2,1,1,33,-2,-2,-2,-2,-2,-2,14150,8106,12431,12145,13391,7957,8106,12431,12145,13391,7957,1905,0,6044,-4325,286,-1246,5434,6052,68180,-12,55935,42.6125
662,90000,1,2,1,40,0,0,0,-1,-1,-1,42856,44925,0,787,1457,0,3114,0,787,1457,0,0,1,39742,44925,-787,-670,1457,0,90025,-3,5358,100.02777777777779
663,140000,2,1,2,37,-1,-1,-1,-2,-2,-1,1034,40000,0,0,0,510,40000,0,0,0,510,0,0,-38966,40000,0,0,-510,510,41544,-8,40510,29.674285714285713
664,50000,1,1,2,22,0,0,0,0,0,-1,5137,5960,6270,6000,5810,390,1300,1000,120,200,390,1170,0,3837,4960,6150,5800,5420,-780,29567,-1,4180,59.134
665,40000,2,2,1,32,0,0,0,2,2,2,24114,25417,28777,29107,29693,30456,2000,4110,1100,1200,1400,0,0,22114,21307,27677,27907,28293,30456,167564,6,9810,418.90999999999997
666,130000,2,3,1,43,0,0,0,0,0,0,130067,129385,96775,98071,97743,100124,5540,4403,3814,3562,4021,3681,0,124527,124982,92961,94509,93722,96443,652165,0,25021,501.66538461538465
667,70000,2,3,1,27,0,0,0,0,0,2,61611,62711,63695,63926,67361,59480,3011,3095,2000,4600,0,2258,0,58600,59616,61695,59326,67361,57222,378784,2,14964,541.12
668,30000,2,2,1,35,0,0,0,0,0,0,25078,25538,25880,25873,26157,26918,1500,1387,893,1000,1501,2000,0,23578,24151,24987,24873,24656,24918,155444,0,8281,518.1466666666668
669,100000,2,3,1,35,1,2,2,2,2,2,97002,102698,97997,103384,97266,101492,8200,0,8000,0,8600,0,0,88802,102698,89997,103384,88666,101492,599839,11,24800,599.8389999999999
670,20000,2,1,1,30,2,2,2,0,0,0,5766,7511,7678,7318,7458,7598,2000,500,0,500,500,0,1,3766,7011,7678,6818,6958,7598,43329,6,3500,216.645
671,30000,2,2,2,34,2,-1,2,2,2,2,99568,32326,31840,37075,37662,36904,33000,33000,5810,1325,0,3095,0,66568,-674,26030,35750,37662,33809,275375,9,76230,917.9166666666667
672,20000,1,2,1,34,0,0,0,0,0,0,12857,14183,14890,15642,16387,17113,1541,1248,1000,1000,1000,1000,1,11316,12935,13890,14642,15387,16113,91072,0,6789,455.36
673,100000,2,1,2,28,2,0,0,0,0,0,96193,82342,81967,82177,78840,79261,3600,3800,3000,3000,3023,3000,1,92593,78542,78967,79177,75817,76261,500780,2,19423,500.78
674,30000,1,2,2,25,2,2,7,7,7,6,2400,2400,2400,2400,2400,1800,0,0,0,0,0,0,1,2400,2400,2400,2400,2400,1800,13800,31,0,46.0
675,320000,2,1,1,41,0,0,0,0,0,0,97797,99672,101953,102284,104090,105859,4520,5050,3590,3700,3750,3510,0,93277,94622,98363,98584,100340,102349,611655,0,24120,191.1421875
676,90000,1,3,2,42,2,2,2,2,2,2,64762,63164,32789,31641,29240,28306,0,2900,0,2500,0,1300,1,64762,60264,32789,29141,29240,27006,249902,12,6700,277.6688888888889
677,190000,1,2,2,40,2,2,2,2,2,2,145613,156765,159386,161870,165725,169928,15000,6600,6500,6500,7000,7000,1,130613,150165,152886,155370,158725,162928,959287,12,48600,504.8878947368421
678,200000,1,1,2,28,0,0,0,0,0,0,71989,122129,147936,149573,152574,156323,52129,30000,6000,6000,7000,10000,0,19860,92129,141936,143573,145574,146323,800524,0,111129,400.26200000000006
679,300000,2,2,2,31,-1,-1,-1,-1,0,-1,3345,1083,4339,7423,4059,2508,1087,4355,7423,0,2508,4141,0,2258,-3272,-3084,7423,1551,-1633,22757,-5,19514,7.585666666666667
680,30000,2,1,2,56,-1,0,0,-2,-2,-2,29033,17013,7024,7024,7024,7024,1283,7024,7024,7024,7024,7024,0,27750,9989,0,0,0,0,74142,-7,36403,247.14000000000001
681,110000,2,2,3,45,0,0,0,0,0,0,26650,20787,20566,21158,22141,22158,1532,2000,783,3000,2000,2000,0,25118,18787,19783,18158,20141,20158,133460,0,11315,121.32727272727273
682,230000,2,1,2,29,-2,-2,-2,-2,-2,-2,0,0,1024,0,0,0,0,1024,0,0,0,0,0,0,-1024,1024,0,0,0,1024,-12,1024,0.4452173913043478
683,230000,2,1,1,35,0,0,0,0,-2,-2,4259,5432,6182,0,0,0,1250,1000,0,0,0,0,0,3009,4432,6182,0,0,0,15873,-4,2250,6.901304347826088
684,310000,2,2,2,28,0,0,0,0,0,0,106468,108955,112374,54762,58189,57170,8000,6000,5000,5000,4000,5000,0,98468,102955,107374,49762,54189,52170,497918,0,33000,160.61870967741936
685,320000,1,1,1,40,0,0,0,0,0,0,247276,241167,238196,231580,229683,235837,10000,10000,10000,19000,13000,8000,0,237276,231167,228196,212580,216683,227837,1423739,0,70000,444.9184375
686,360000,1,1,1,47,-1,-1,-1,0,-1,-1,1548,-32,177639,174397,4852,4125,0,177671,3508,4876,4188,10007,0,1548,-177703,174131,169521,664,-5882,362529,-5,200250,100.7025
687,20000,2,3,1,41,-1,-1,-1,0,0,0,780,0,732,642,1252,643,0,732,300,1000,500,1000,1,780,-732,432,-358,752,-357,4049,-3,3532,20.244999999999997
688,170000,2,2,2,27,0,0,0,0,0,0,162671,166202,161973,167201,161327,171863,7500,6000,10000,7000,16000,6200,0,155171,160202,151973,160201,145327,165663,991237,0,52700,583.0805882352942
689,140000,1,1,1,40,0,0,0,0,0,0,123049,125616,129695,130735,133467,136287,4310,5913,4426,4580,4770,4767,0,118739,119703,125269,126155,128697,131520,778849,0,28766,556.3207142857143
690,80000,1,2,2,32,0,0,0,0,0,0,51372,51872,47593,43882,42256,42527,1853,1700,1522,1548,1488,1500,0,49519,50172,46071,42334,40768,41027,279502,0,9611,349.3775
691,150000,1,2,2,35,0,0,0,-1,-1,-1,60015,72227,51364,54340,0,2129,20000,30000,54340,0,2129,0,0,40015,42227,-2976,54340,-2129,2129,240075,-3,106469,160.05
692,170000,1,2,2,27,-1,2,2,-2,-2,-2,1170,780,0,0,0,0,0,0,0,0,0,0,0,1170,780,0,0,0,0,1950,-3,0,1.1470588235294117
693,200000,2,2,1,29,2,0,0,0,0,0,159398,156955,132144,119136,122211,125021,6163,4530,4500,5000,5000,5000,1,153235,152425,127644,114136,117211,120021,814865,2,30193,407.4325
694,70000,1,1,2,30,0,0,2,0,0,2,55664,59529,57571,57871,60872,59329,5800,0,2250,4500,0,2500,0,49864,59529,55321,53371,60872,56829,350836,4,15050,501.19428571428574
695,320000,1,2,1,37,-2,-2,-2,-2,-2,-2,43528,498,429,14257,5417,2967,500,431,14328,5439,2980,5028,0,43028,67,-13899,8818,2437,-2061,67096,-12,28706,20.9675
696,150000,2,1,2,29,-2,-2,-2,-2,-2,-2,0,0,0,0,0,0,0,0,0,0,0,0,0,0,0,0,0,0,0,0,-12,0,0.0
697,50000,2,1,1,34,0,0,0,-1,0,0,27966,28539,11597,6611,7349,7570,1267,1553,7511,1000,343,1000,0,26699,26986,4086,5611,7006,6570,89632,-1,12674,179.264
698,90000,2,2,2,34,-1,2,2,-2,-2,-2,8792,7500,0,0,0,0,0,0,0,0,0,0,0,8792,7500,0,0,0,0,16292,-3,0,18.102222222222224
699,280000,1,1,1,41,-2,-2,-2,-2,-1,0,28026,41302,51500,35752,3955,13969,41346,52110,35752,3955,13939,4437,0,-13320,-10808,15748,31797,-9984,9532,174504,-9,151539,62.322857142857146
700,300000,2,1,2,31,0,0,0,0,2,-1,43610,43280,36156,30305,30155,561,1655,1797,750,0,561,500,0,41955,41483,35406,30305,29594,61,184067,1,5263,61.355666666666664
701,400000,2,2,2,40,-2,-2,-2,-2,-1,-1,0,8235,0,0,1524,0,8235,0,0,1524,0,385,0,-8235,8235,0,-1524,1524,-385,9759,-10,10144,2.43975
702,200000,2,1,1,27,-1,-1,-1,-1,-1,-1,5780,105,105,0,7384,8588,105,105,0,7384,8588,1304,0,5675,0,105,-7384,-1204,7284,21962,-6,17486,10.981
703,10000,2,3,2,22,0,0,0,0,-2,-2,8109,9778,8259,0,0,0,2000,1036,0,0,0,0,1,6109,8742,8259,0,0,0,26146,-4,3036,261.46
704,50000,2,2,3,30,1,3,2,0,0,0,52515,51424,49967,20036,20076,37615,0,0,2000,1000,1000,1600,1,52515,51424,47967,19036,19076,36015,231633,6,5600,463.26599999999996
705,30000,2,2,3,22,1,2,4,3,2,2,22582,26518,25814,25110,24569,26357,4600,0,0,0,2200,2500,0,17982,26518,25814,25110,22369,23857,150950,14,9300,503.16666666666663
706,50000,1,1,2,26,-1,0,0,0,0,0,15448,16392,18096,18425,18619,19060,1500,2000,1500,1200,900,1000,1,13948,14392,16596,17225,17719,18060,106040,-1,8100,212.08
707,50000,1,2,1,38,1,2,0,0,0,0,58102,59011,56272,53663,51507,50616,2500,2500,2000,2000,3200,2000,0,55602,56511,54272,51663,48307,48616,329171,3,14200,658.342
708,30000,2,3,1,46,1,2,2,2,2,2,12289,11806,13268,12758,13549,14673,0,1970,0,1000,1500,0,0,12289,9836,13268,11758,12049,14673,78343,11,4470,261.1433333333333
709,20000,1,2,2,24,0,0,-1,2,0,0,10476,7279,688,688,688,1320,1000,688,0,0,650,0,0,9476,6591,688,688,38,1320,21139,1,2338,105.69500000000001
710,20000,1,2,2,49,0,0,0,0,0,0,16326,17497,18456,18424,18800,10000,1441,1400,368,376,200,0,0,14885,16097,18088,18048,18600,10000,99503,0,3785,497.51500000000004
711,50000,1,1,3,49,0,0,0,0,0,0,17681,18249,18054,18569,19152,18088,1611,2000,780,1000,1000,2000,0,16070,16249,17274,17569,18152,16088,109793,0,8391,219.586
712,30000,2,2,1,42,0,0,0,0,0,0,47912,25023,25768,26410,27960,46254,1755,1500,1000,1909,1000,2000,0,46157,23523,24768,24501,26960,44254,199327,0,9164,664.4233333333333
713,360000,2,1,1,30,1,2,-1,0,-1,-1,18886,14249,3821,2404,319,0,0,3828,2000,319,0,0,0,18886,10421,1821,2085,319,0,39679,0,6147,11.021944444444443
714,170000,1,2,1,42,1,-1,-1,-2,-2,-1,0,1690,0,0,0,4750,1690,0,0,0,4750,0,0,-1690,1690,0,0,-4750,4750,6440,-6,6440,3.788235294117647
715,400000,2,1,2,31,-2,-2,-2,-2,-2,-2,203,767,664,1250,-10,2174,770,667,1256,0,2184,0,0,-567,100,-592,1250,-2194,2174,5048,-12,4877,1.262
716,50000,2,2,1,49,0,0,0,0,0,0,34962,32275,31253,32014,33573,29645,1613,2000,1500,2000,1645,1064,0,33349,30275,29753,30014,31928,28581,193722,0,9822,387.44399999999996
717,160000,2,2,2,27,0,0,0,0,0,0,80964,80337,82182,82586,85145,87049,4000,4000,3500,4000,4000,2500,0,76964,76337,78682,78586,81145,84549,498263,0,22000,311.414375
718,70000,2,2,1,33,0,0,0,0,0,0,69418,68943,38783,3758,1261,0,2382,2025,1000,25,0,1651,1,67036,66918,37783,3733,1261,-1651,182163,0,7083,260.23285714285714
719,150000,2,1,1,35,1,-2,-2,-2,-2,-2,0,0,0,0,0,0,0,0,0,0,0,0,0,0,0,0,0,0,0,0,-9,0,0.0
720,80000,2,2,2,48,0,0,0,0,0,0,45174,41885,42832,23799,11723,27236,3000,3413,2000,5000,17236,2000,0,42174,38472,40832,18799,-5513,25236,192649,0,32649,240.81125
721,30000,2,2,2,22,0,0,2,0,0,0,23892,28459,25499,25778,28708,30520,5300,0,1000,3352,2300,0,0,18592,28459,24499,22426,26408,30520,162856,2,11952,542.8533333333334
722,10000,1,2,2,22,0,0,0,0,0,0,7960,9649,8518,8628,9293,5033,2000,1000,500,1500,0,2500,1,5960,8649,8018,7128,9293,2533,49081,0,7500,490.81
723,180000,2,1,2,27,1,-1,-1,-1,-1,-1,0,3338,3333,3333,3333,3333,3338,3333,3333,3333,3333,3333,0,-3338,5,0,0,0,0,16670,-4,20003,9.261111111111111
724,320000,1,1,1,47,-1,-1,-1,-1,-1,-1,9192,13920,4022,316,8420,316,13942,4022,316,8420,316,516,0,-4750,9898,3706,-8104,8104,-200,36186,-6,27532,11.308124999999999
725,80000,2,2,2,34,0,0,0,2,2,2,25935,27210,28783,30003,29385,31401,2000,2338,2000,0,2500,0,0,23935,24872,26783,30003,26885,31401,172717,6,8838,215.89624999999998
726,10000,1,2,1,45,0,0,0,2,0,0,7139,8416,9815,9508,9754,10192,1400,1700,0,400,600,200,1,5739,6716,9815,9108,9154,9992,54824,2,4300,548.24
727,360000,2,2,2,39,-1,-1,-1,0,-1,-1,12865,4462,19560,8894,5329,998,4484,19623,222,5355,998,9004,0,8381,-15161,19338,3539,4331,-8006,52108,-5,39686,14.474444444444446
728,450000,1,2,2,33,-2,-2,-2,-2,-2,-2,-14,2568,-387,-387,-387,113,2582,0,0,0,500,2515,0,-2596,2568,-387,-387,-887,-2402,1506,-12,5597,0.33466666666666667
729,330000,2,2,2,29,0,0,0,0,-1,-1,49549,133957,128212,79407,8875,49880,90000,3000,5000,8875,49880,519,0,-40451,130957,123212,70532,-41005,49361,449880,-2,157274,136.3272727272727
730,60000,1,1,2,29,-1,2,-1,-1,2,2,546,255,464,1173,732,1023,0,500,1000,0,582,0,1,546,-245,-536,1173,150,1023,4193,3,2082,6.988333333333334
731,50000,2,3,2,26,0,0,0,0,0,0,9935,11029,12795,9983,10884,7666,1234,2000,297,1000,307,361,0,8701,9029,12498,8983,10577,7305,62292,0,5199,124.584
732,200000,1,2,1,38,0,0,0,0,0,0,152856,156104,158279,161934,165447,168802,6000,5000,5000,5000,4917,10000,0,146856,151104,153279,156934,160530,158802,963422,0,35917,481.71099999999996
733,120000,1,1,2,34,1,2,-1,-1,-2,-2,1278,639,621,-18,-18,-18,0,621,0,0,0,0,0,1278,18,621,-18,-18,-18,2484,-3,621,2.07
734,160000,2,1,1,37,-1,-1,-1,-1,-1,-1,316,316,0,316,632,0,316,0,316,632,0,316,0,0,316,-316,-316,632,-316,1580,-6,1580,0.9875
735,110000,1,2,1,57,0,0,0,0,0,0,46132,41050,40091,40659,38529,30900,2306,2111,3009,1725,1500,0,0,43826,38939,37082,38934,37029,30900,237361,0,10651,215.7827272727273
736,70000,2,3,1,50,-2,-2,-1,0,0,0,27345,-1041,17571,17920,18296,18659,1041,18862,640,663,666,690,0,26304,-19903,16931,17257,17630,17969,98750,-5,22562,141.07142857142858
737,150000,2,3,2,28,0,0,0,0,0,0,101593,101886,101441,100829,101913,96704,4000,4032,3410,4000,3665,3050,0,97593,97854,98031,96829,98248,93654,604366,0,22157,402.91066666666666
738,610000,2,1,2,31,0,0,0,0,0,0,142764,126606,67887,58397,105301,105965,6540,2100,2150,50000,4700,2000,0,136224,124506,65737,8397,100601,103965,606920,0,67490,99.49508196721311
739,110000,2,1,2,25,0,0,0,0,0,0,92849,94766,93894,85723,86443,84011,4346,4075,3144,3238,3167,3202,0,88503,90691,90750,82485,83276,80809,537686,0,21172,488.8054545454546
740,80000,2,2,2,25,2,0,0,2,0,0,17330,19258,23416,22768,23243,23718,3000,4790,0,816,833,2000,1,14330,14468,23416,21952,22410,21718,129733,4,11439,162.16625
741,170000,2,2,1,33,0,0,0,0,0,0,109863,79574,78440,80141,81862,84237,4380,3000,3000,3000,4000,4500,0,105483,76574,75440,77141,77862,79737,514117,0,21880,302.42176470588237
742,110000,2,1,2,30,-1,-1,-1,-1,-2,-2,1064,2001,3796,0,0,0,2007,3796,0,0,0,0,0,-943,-1795,3796,0,0,0,6861,-8,5803,6.237272727272727
743,140000,2,1,1,51,0,0,0,0,0,0,56764,57950,57668,55024,55883,55744,2115,2004,1941,2073,1909,2132,0,54649,55946,55727,52951,53974,53612,339033,0,12174,242.16642857142858
744,70000,1,1,2,51,0,0,0,2,0,0,43048,43257,44115,41112,39922,40150,3000,4000,0,1500,3000,5000,0,40048,39257,44115,39612,36922,35150,251604,2,16500,359.43428571428575
745,260000,2,2,1,46,-2,-2,-2,-2,-2,-2,29484,28592,16869,12713,10420,12532,10000,3000,12713,10420,12532,12151,0,19484,25592,4156,2293,-2112,381,110610,-12,60816,42.54230769230769
746,170000,1,3,2,38,0,0,0,0,0,0,21310,22957,24266,25556,29949,34434,2000,2000,2000,5000,5000,5000,0,19310,20957,22266,20556,24949,29434,158472,0,21000,93.21882352941176
747,50000,2,2,1,34,0,0,0,0,0,0,10821,11877,13656,14949,16567,16826,1221,2000,1500,2000,2000,4000,0,9600,9877,12156,12949,14567,12826,84696,0,12721,169.392
748,300000,2,3,1,34,0,0,0,0,0,0,280823,275303,271952,193403,187562,191069,11000,12000,7200,6500,6173,5500,1,269823,263303,264752,186903,181389,185569,1400112,0,48373,466.704
749,150000,2,1,2,31,2,-1,-1,-1,-1,-1,390,390,390,4825,5202,780,390,390,4825,5202,780,0,1,0,0,-4435,-377,4422,780,11977,-3,11587,7.984666666666667
750,50000,2,2,2,25,8,7,6,5,4,3,37647,37102,36238,36374,35229,34365,0,0,1000,0,0,3000,1,37647,37102,35238,36374,35229,31365,216955,33,4000,433.91
751,50000,2,2,1,26,1,-2,-1,0,0,0,0,0,1756,2719,4049,5176,0,1756,1000,1537,1200,2000,0,0,-1756,756,1182,2849,3176,13700,-2,7493,27.400000000000002
752,90000,2,1,2,25,2,0,0,0,0,-1,84710,87334,87862,18889,-783,73568,4000,3258,1000,0,77500,0,0,80710,84076,86862,18889,-78283,73568,351580,1,85758,390.64444444444445
753,50000,1,2,2,26,0,0,0,0,0,0,48036,46787,42011,19147,2845,20041,2100,1227,383,2000,20000,649,1,45936,45560,41628,17147,-17155,19392,178867,0,26359,357.734
754,500000,2,2,2,43,-1,0,0,0,0,0,43346,43976,39032,29092,22725,11590,4006,2383,1126,782,596,1572,0,39340,41593,37906,28310,22129,10018,189761,-1,10465,37.952200000000005
755,470000,2,2,1,36,-1,0,0,-1,-1,-1,873,1593,1518,285,688,2100,1005,1000,285,688,2100,1014,0,-132,593,1233,-403,-1412,1086,7057,-4,6092,1.5014893617021277
756,230000,1,2,2,58,0,0,0,0,0,0,110163,112499,114837,116400,45643,51083,5600,5700,5000,1855,6400,0,0,104563,106799,109837,114545,39243,51083,550625,0,24555,239.40217391304347
757,140000,2,2,2,26,0,0,-1,-1,0,0,4113,6030,16025,24616,19458,20047,2000,16025,24616,1000,1000,1000,0,2113,-9995,-8591,23616,18458,19047,90289,-2,45641,64.49214285714285
758,230000,2,2,1,30,2,0,-1,-1,-1,-1,9636,10152,1817,-828,6153,12663,1222,1837,0,7863,12675,2959,1,8414,8315,1817,-8691,-6522,9704,39593,-2,26556,17.214347826086957
759,420000,2,2,2,31,0,0,0,0,-1,-1,25103,21330,16024,9603,2131,64507,1509,1067,3061,2210,64524,2324,0,23594,20263,12963,7393,-62393,62183,138698,-2,74695,33.02333333333333
760,30000,2,2,2,24,0,0,0,0,0,0,31319,31181,31540,31016,30531,30528,1564,1800,1100,1500,1500,3000,0,29755,29381,30440,29516,29031,27528,186115,0,10464,620.3833333333333
761,50000,2,2,2,52,1,2,0,0,0,2,43343,43360,23417,21969,21179,18711,1300,1400,920,1700,0,900,1,42043,41960,22497,20269,21179,17811,171979,5,6220,343.95799999999997
762,140000,2,2,2,24,-1,-1,-2,-1,-1,-2,197,0,0,233,0,0,0,0,233,0,0,0,0,197,0,-233,233,0,0,430,-8,233,0.3071428571428571
763,260000,2,2,1,35,-1,-1,-1,-1,-1,0,7967,67650,6000,0,88348,85962,67650,6000,0,88348,5000,25000,0,-59683,61650,6000,-88348,83348,60962,255927,-5,191998,98.43346153846154
764,90000,2,3,2,29,-1,2,-1,-1,-1,-2,19450,3123,2121,3113,0,0,0,3509,3113,0,0,0,0,19450,-386,-992,3113,0,0,27807,-4,6622,30.89666666666667
765,240000,2,2,1,33,0,0,0,0,0,0,240878,233838,238067,242579,238245,233710,10000,11000,10000,10000,10000,8000,0,230878,222838,228067,232579,228245,225710,1427317,0,59000,594.7154166666667
766,510000,2,1,2,35,-1,0,0,0,0,-1,2115,2116,5560,4535,3488,1116,1117,4560,91,69,1116,2115,0,998,-2444,5469,4466,2372,-999,18930,-2,9068,3.7117647058823526
767,110000,2,2,1,35,0,0,0,0,0,0,81665,46070,34419,36829,38080,40434,2460,2000,3000,2000,3000,5000,0,79205,44070,31419,34829,35080,35434,277497,0,17460,252.26999999999998
768,210000,2,1,2,28,-1,-1,-1,0,0,0,11442,3738,7526,10217,11737,8114,3738,7526,5000,5000,162,27760,0,7704,-3788,2526,5217,11575,-19646,52774,-3,49186,25.13047619047619
769,220000,1,2,1,40,-1,-1,-2,-2,-2,-2,158,0,0,0,0,612,0,0,0,0,612,1863,0,158,0,0,0,-612,-1251,770,-10,2475,0.35000000000000003
770,200000,2,1,1,35,-2,-2,-2,-2,-2,-2,2257,4261,1265,2473,0,0,4266,1667,2473,0,0,0,0,-2009,2594,-1208,2473,0,0,10256,-12,8406,5.128
771,360000,2,2,2,53,-1,-1,-1,-1,-1,-1,10733,15206,15000,9744,11114,8123,15206,15032,9769,11114,8123,8736,0,-4473,174,5231,-1370,2991,-613,69920,-6,67980,19.42222222222222
772,260000,1,1,2,44,-1,-1,-1,-1,-1,-1,316,316,316,316,316,466,316,316,316,316,466,316,0,0,0,0,0,-150,150,2046,-6,2046,0.786923076923077
773,20000,1,2,1,33,0,0,0,0,0,0,11026,9535,10510,10472,10140,10101,1174,1149,501,356,507,458,0,9852,8386,10009,10116,9633,9643,61784,0,4145,308.92
774,120000,2,2,1,32,0,0,0,0,0,0,113869,116110,111978,112822,114969,117949,5498,5500,4000,4300,5012,4003,0,108371,110610,107978,108522,109957,113946,687697,0,28313,573.0808333333333
775,50000,2,1,2,33,-1,2,-1,-1,-1,-2,7363,5180,31902,11044,0,0,39,32013,11079,0,0,0,0,7324,-26833,20823,11044,0,0,55489,-4,43131,110.978
776,60000,2,1,2,26,1,2,0,0,0,0,29649,21657,28736,42733,46404,37993,0,8000,15000,9000,10000,0,0,29649,13657,13736,33733,36404,37993,207172,3,42000,345.28666666666663
777,200000,1,1,2,26,-2,-2,-2,-2,-1,-1,12716,16164,1954,5297,1483,3393,16244,1963,3359,4849,3410,2994,0,-3528,14201,-1405,448,-1927,399,41007,-10,32819,20.5035
778,20000,1,2,2,26,-1,-1,-1,-1,-2,-1,1438,1261,451,-810,-420,1320,1261,451,0,780,2130,0,0,177,810,451,-1590,-2550,1320,3240,-7,4622,16.2
779,50000,2,1,1,32,2,0,0,-1,0,-1,47858,49223,42589,639,4639,2312,2500,3000,7000,4000,2413,2000,1,45358,46223,35589,-3361,2226,312,147260,0,20913,294.52
780,50000,2,2,2,31,1,-2,-1,-1,-1,2,0,0,190,0,36059,32851,0,190,0,36059,0,2420,0,0,-190,190,-36059,36059,30431,69100,-2,38669,138.2
781,230000,1,1,2,29,0,0,2,2,2,0,40732,44563,42804,44020,41278,34672,5000,0,3000,0,3000,3000,0,35732,44563,39804,44020,38278,31672,248069,6,14000,107.85608695652174
782,50000,1,2,1,27,-1,-1,2,-1,-1,-1,819,3003,1677,1177,1313,1085,2184,5,1180,1316,1088,0,0,-1365,2998,497,-139,225,1085,9074,-3,5773,18.148
783,100000,2,1,2,28,2,2,2,2,2,2,79580,81493,82759,83609,85325,87096,3790,3200,3100,3200,3332,3280,1,75790,78293,79659,80409,81993,83816,499862,12,19902,499.86199999999997
784,210000,2,1,1,42,1,-2,-1,-1,-2,-2,0,0,2490,0,0,0,0,2490,0,0,0,0,1,0,-2490,2490,0,0,0,2490,-7,2490,1.1857142857142857
785,230000,2,2,1,32,0,0,0,0,2,0,87764,73526,72376,76870,75211,76645,2630,2614,6000,0,3000,2800,1,85134,70912,66376,76870,72211,73845,462392,2,17044,201.04000000000002
786,500000,2,1,2,26,1,-2,-2,-2,-2,-2,31421,22150,0,0,0,0,22157,0,0,0,0,0,0,9264,22150,0,0,0,0,53571,-9,22157,10.7142
787,370000,2,1,2,38,-1,-1,-1,-1,-1,-1,929,328,0,1539,1815,0,328,0,1539,1815,0,0,0,601,328,-1539,-276,1815,0,4611,-6,3682,1.2462162162162163
788,230000,2,1,1,35,-1,-1,-1,-1,0,0,2648,191,1947,11674,16160,32519,200,1950,11692,10000,20000,6000,0,2448,-1759,-9745,1674,-3840,26519,65139,-4,49842,28.321304347826086
789,80000,1,2,2,29,0,0,0,0,0,0,11894,12287,12407,14360,14657,4129,1284,1047,2000,359,175,1000,0,10610,11240,10407,14001,14482,3129,69734,0,5865,87.1675
790,60000,2,2,2,29,-1,0,0,0,-2,-2,55064,57833,9479,0,0,0,5000,1033,0,0,0,0,0,50064,56800,9479,0,0,0,122376,-5,6033,203.96
791,30000,2,2,2,51,1,2,2,0,0,0,25382,26480,25761,25964,26507,27249,1800,0,928,960,1181,967,0,23582,26480,24833,25004,25326,26282,157343,5,5836,524.4766666666667
792,70000,1,1,2,27,1,-1,-1,-1,-2,-1,-54,273,19,-254,-527,1096,600,19,0,0,1896,0,0,-654,254,19,-254,-2423,1096,553,-5,2515,0.79
793,410000,1,1,2,32,-1,-1,-1,-2,-2,-2,5335,5369,-281,-281,-281,-281,5400,0,0,0,0,0,0,-65,5369,-281,-281,-281,-281,9580,-9,5400,2.3365853658536584
794,280000,2,3,1,40,1,-2,-2,-2,-2,-2,-288,-288,-288,-288,-288,2124,0,0,0,0,2412,0,0,-288,-288,-288,-288,-2700,2124,684,-9,2412,0.2442857142857143
795,50000,2,1,1,34,0,0,0,0,0,0,46750,48317,48282,18299,19323,20329,2320,1282,3299,1323,1329,1114,0,44430,47035,44983,16976,17994,19215,201300,0,10667,402.59999999999997
796,100000,2,2,1,30,0,0,0,0,0,0,97062,74352,75004,76705,78168,80347,2800,2700,5400,3500,3500,3200,0,94262,71652,69604,73205,74668,77147,481638,0,21100,481.638
797,230000,2,1,2,29,-2,-2,-2,-2,-2,-2,0,0,0,0,0,0,0,0,0,0,0,0,0,0,0,0,0,0,0,0,-12,0,0.0
798,50000,2,1,2,22,0,0,0,-1,-1,-2,13801,9549,5385,7781,0,0,1372,1275,7900,0,0,0,0,12429,8274,-2515,7781,0,0,36516,-4,10547,73.032
799,100000,2,1,2,48,2,2,2,2,2,0,15355,17949,18158,18365,17932,18147,3164,800,800,0,662,3000,0,12191,17149,17358,18365,17270,15147,105906,10,8426,105.90599999999999
800,210000,2,2,1,35,0,0,0,0,0,0,37148,35754,34232,32331,30337,28012,2000,2000,2444,1342,1038,2000,0,35148,33754,31788,30989,29299,26012,197814,0,10824,94.19714285714285
801,400000,1,1,2,37,-1,-1,-1,-1,-2,-1,385,12695,1290,0,0,3058,13032,1290,0,0,3058,3768,0,-12647,11405,1290,0,-3058,-710,17428,-7,21148,4.356999999999999
802,20000,1,2,2,25,4,3,2,0,0,0,20610,20005,19331,19333,17363,16314,0,0,500,715,326,0,1,20610,20005,18831,18618,17037,16314,112956,9,1541,564.78
803,50000,2,3,1,44,-1,-1,-1,-1,0,0,2000,780,0,7472,10174,11104,780,0,7472,3000,1104,1000,0,1220,780,-7472,4472,9070,10104,31530,-4,13356,63.06
804,230000,2,1,2,28,-1,-1,-1,-2,-2,-2,6666,6666,0,0,0,0,6666,0,0,0,0,0,0,0,6666,0,0,0,0,13332,-9,6666,5.796521739130435
805,220000,1,2,2,29,0,0,0,-2,-2,-2,31037,6244,0,0,0,0,3050,0,0,0,0,0,0,27987,6244,0,0,0,0,37281,-6,3050,16.94590909090909
806,300000,2,1,1,36,0,0,0,0,-2,-1,25239,25001,20800,0,0,65755,1713,1000,0,0,65755,3000,0,23526,24001,20800,0,-65755,62755,136795,-3,71468,45.598333333333336
807,80000,2,2,2,23,1,-1,2,-1,-1,-1,998,6858,1879,1145,7328,3703,6861,11,1146,7329,3704,426,0,-5863,6847,733,-6184,3624,3277,21911,-1,19477,27.38875
808,20000,2,3,2,36,0,0,2,2,2,2,16754,18873,19862,19245,20532,19953,2400,1600,0,1600,209,0,1,14354,17273,19862,17645,20323,19953,115219,8,5809,576.095
809,190000,2,1,2,26,0,0,0,0,0,2,31061,32129,33142,33726,35758,35171,1750,1720,1300,2600,0,1400,0,29311,30409,31842,31126,35758,33771,200987,2,8770,105.78263157894736
810,160000,2,2,0,37,0,0,0,0,0,0,2694,38433,38870,28574,27268,28021,35888,1325,891,1000,1098,426,0,-33194,37108,37979,27574,26170,27595,163860,0,40628,102.4125
811,120000,2,1,3,44,0,0,2,0,0,0,70096,76446,73732,12329,12329,0,8100,0,247,0,0,0,0,61996,76446,73485,12329,12329,0,244932,2,8347,204.11
812,700000,2,1,1,39,0,0,0,0,-2,-1,99259,102345,109636,326,2016,61707,5000,10000,326,2016,61707,17785,0,94259,92345,109310,-1690,-59691,43922,375289,-3,96834,53.61271428571428
813,140000,2,1,2,24,1,-2,-2,-2,-1,-1,0,0,0,0,1086,0,0,0,0,1086,0,0,0,0,0,0,-1086,1086,0,1086,-7,1086,0.7757142857142857
814,300000,2,3,1,29,-1,0,0,0,0,-1,24921,21333,16212,11304,11396,6138,2000,3000,0,5000,6202,0,0,22921,18333,16212,6304,5194,6138,91304,-2,16202,30.434666666666665
815,120000,1,3,1,33,1,2,2,2,2,2,66055,67405,68405,69387,70727,72215,3000,2700,2700,2600,2800,0,1,63055,64705,65705,66787,67927,72215,414194,11,13800,345.1616666666667
816,280000,2,2,1,39,0,0,2,0,0,0,213738,228963,223810,158542,162244,108143,20300,0,5600,6300,4000,4000,0,193438,228963,218210,152242,158244,104143,1095440,2,40200,391.22857142857146
817,70000,1,3,1,51,2,2,0,0,0,0,54968,51384,49734,50361,49185,47245,0,2100,1950,1900,2219,2100,1,54968,49284,47784,48461,46966,45145,302877,4,10269,432.68142857142857
818,20000,2,3,2,24,-1,-1,-1,-1,-1,2,4101,507,3042,0,8402,6204,507,3042,0,8402,0,4739,0,3594,-2535,3042,-8402,8402,1465,22256,-3,16690,111.28
819,150000,2,2,1,45,-1,-1,-1,-1,-1,-1,2605,2605,4590,2605,2605,3795,2605,4590,2605,2605,3795,10675,0,0,-1985,1985,0,-1190,-6880,18805,-6,26875,12.536666666666665
820,60000,1,1,2,30,0,-1,0,0,0,0,15380,4116,19453,17912,18480,18848,4147,19435,1000,1000,1000,1000,0,11233,-15319,18453,16912,17480,17848,94189,-1,27582,156.98166666666665
821,200000,2,3,0,51,-1,-1,-1,-1,0,-1,780,0,390,780,390,390,0,390,780,0,390,390,0,780,-390,-390,780,0,0,2730,-5,1950,1.365
822,50000,2,2,2,24,1,2,0,0,0,0,48861,48082,48614,26667,26036,26850,2000,2233,1083,1100,1400,3000,1,46861,45849,47531,25567,24636,23850,225110,3,10816,450.22
823,150000,1,2,1,50,-1,0,0,2,0,0,55336,58255,36260,35037,34631,63156,5085,4000,0,2000,30000,5000,0,50251,54255,36260,33037,4631,58156,282675,1,46085,188.45000000000002
824,20000,2,1,2,22,0,0,0,0,0,0,20243,20400,19583,19983,20196,19705,1410,1200,534,700,1000,0,0,18833,19200,19049,19283,19196,19705,120110,0,4844,600.55
825,40000,1,1,2,27,0,0,0,0,0,0,11058,11471,11776,12660,12660,12413,2000,1500,2330,2300,1000,2078,1,9058,9971,9446,10360,11660,10335,72038,0,11208,180.095
826,170000,2,2,2,33,1,-1,-1,-1,-2,-2,0,7042,2986,0,0,0,7042,2986,0,0,0,0,0,-7042,4056,2986,0,0,0,10028,-6,10028,5.898823529411764
827,50000,2,2,1,24,1,2,0,0,0,2,27087,26372,26992,27693,29237,28607,0,1400,1100,2100,0,1000,0,27087,24972,25892,25593,29237,27607,165988,5,5600,331.976
828,10000,1,2,2,37,0,0,0,0,2,2,8755,8158,7540,8164,6963,5923,1167,1022,1036,0,2700,0,0,7588,7136,6504,8164,4263,5923,45503,4,5925,455.03
829,200000,2,2,1,58,-1,-1,-1,-1,-2,-1,3035,199602,720,0,0,1500,199646,720,0,0,1500,185652,0,-196611,198882,720,0,-1500,-184152,204857,-7,387518,102.42849999999999
830,50000,2,2,1,48,0,-1,-1,0,0,0,20944,4696,47225,16483,9343,9693,2360,49325,3001,1882,500,503,0,18584,-44629,44224,14601,8843,9190,108384,-2,57571,216.76799999999997
831,320000,1,1,2,28,-1,0,0,-1,0,0,2007,3477,3037,1633,3633,0,2000,1000,1633,2000,0,3000,0,7,2477,1404,-367,3633,-3000,13787,-2,9633,4.3084375
832,20000,2,3,1,24,8,7,6,5,4,3,24310,23987,23353,22719,21796,21162,0,0,0,0,0,0,0,24310,23987,23353,22719,21796,21162,137327,33,0,686.635
833,470000,2,2,1,27,0,0,0,0,-1,0,152478,62084,54551,14363,97440,90717,3001,4005,2021,97441,5001,5001,1,149477,58079,52530,-83078,92439,85716,471633,-1,116470,100.34744680851064
834,230000,2,3,2,30,-1,-1,-1,0,0,0,550,0,13013,14265,13659,0,0,13013,1252,3659,0,0,0,550,-13013,11761,10606,13659,0,41487,-3,17924,18.03782608695652
835,20000,2,1,2,23,0,0,0,0,0,-2,17246,16988,15973,18773,0,0,2000,2000,3000,0,0,0,0,15246,14988,12973,18773,0,0,68980,-2,7000,344.9
836,30000,2,3,2,53,-1,-1,-1,-1,-1,-1,1598,2487,0,4810,2796,3245,2487,0,4810,2796,3245,7305,1,-889,2487,-4810,2014,-449,-4060,14936,-6,20643,49.78666666666667
837,80000,2,2,2,23,2,2,2,2,2,2,22895,23837,24253,24562,25126,25476,1600,1100,1000,1100,906,0,0,21295,22737,23253,23462,24220,25476,146149,12,5706,182.68625
838,110000,2,2,1,55,0,0,0,0,0,0,15069,16123,16850,17568,18133,18828,1600,1300,1000,1000,1000,1000,0,13469,14823,15850,16568,17133,17828,102571,0,6900,93.24636363636364
839,420000,1,2,1,34,0,0,0,0,0,0,88948,79783,80575,92982,98502,103200,30000,10575,15000,10000,10000,20000,0,58948,69208,65575,82982,88502,83200,543990,0,95575,129.52142857142857
840,500000,1,1,1,43,1,-2,-2,-2,-2,-2,0,0,0,0,0,0,0,0,0,0,0,0,1,0,0,0,0,0,0,0,-9,0,0.0
841,80000,2,2,2,22,1,2,0,0,0,0,79318,79459,79788,29069,26551,27109,2000,2201,2000,1000,1000,2000,0,77318,77258,77788,28069,25551,25109,321294,3,10201,401.61749999999995
842,350000,2,2,1,31,0,0,0,0,0,0,67648,68557,63179,57987,53948,39965,3039,2047,1750,1703,1721,784,0,64609,66510,61429,56284,52227,39181,351284,0,11044,100.36685714285713
843,30000,2,2,1,32,-2,-2,-2,-2,-2,-2,0,0,0,0,7463,6804,0,0,0,7463,6804,4985,0,0,0,0,-7463,659,1819,14267,-12,19252,47.55666666666667
844,110000,2,2,2,33,1,-2,-2,-2,-2,-1,0,0,0,0,0,150,0,0,0,0,300,102,1,0,0,0,0,-300,48,150,-8,402,0.13636363636363638
845,500000,1,3,1,39,0,0,0,0,0,0,315201,332071,375070,354839,369532,367399,25000,50000,20000,19586,14122,12022,0,290201,282071,355070,335253,355410,355377,2114112,0,140730,422.8224
846,490000,2,1,1,38,-1,-1,-1,-1,-1,0,4290,4738,2803,6027,10722,8452,4738,2803,6027,10722,6000,1139,0,-448,1935,-3224,-4695,4722,7313,37032,-5,31429,7.557551020408164
847,300000,2,2,1,34,-2,-2,-2,-2,-2,-2,205064,-86,-86,2014,-185,1815,0,0,2100,0,2000,5000,0,205064,-86,-2186,2014,-2185,-3185,208536,-12,9100,69.512
848,50000,1,2,3,42,2,0,0,2,0,0,47647,50232,50510,32177,29530,29789,3700,3700,0,1072,1500,1132,1,43947,46532,50510,31105,28030,28657,239885,4,11104,479.77
849,150000,1,3,1,37,4,4,4,3,2,0,151117,153787,150320,147989,143355,143131,6500,0,512,0,4388,4221,1,144617,153787,149808,147989,138967,138910,889699,17,15621,593.1326666666668
850,80000,2,3,1,57,-1,2,-1,0,0,0,726,726,15400,15000,15000,15000,0,15400,0,0,0,100,0,726,-14674,15400,15000,15000,14900,61852,0,15500,77.315
851,40000,2,2,2,23,0,0,0,2,2,6,20035,21406,24735,24050,43317,44059,2000,4000,0,20000,2000,0,0,18035,17406,24735,4050,41317,44059,177602,10,28000,444.00500000000005
852,30000,1,2,2,32,1,2,2,0,0,0,29095,30819,29214,29478,23384,22428,2500,0,910,1000,1000,1000,0,26595,30819,28304,28478,22384,21428,164418,5,6410,548.06
853,50000,1,1,1,37,0,0,-2,-2,-2,-2,30400,0,0,0,0,0,500,0,0,0,0,0,0,29900,0,0,0,0,0,30400,-8,500,60.8
854,140000,2,2,2,23,0,0,0,0,0,0,44733,44144,44739,43455,43980,44614,2100,2027,1800,1600,1750,1700,0,42633,42117,42939,41855,42230,42914,265665,0,10977,189.76071428571427
855,50000,2,3,2,49,0,0,0,0,0,0,4987,6741,9366,8566,10066,0,2000,3000,1500,1500,0,0,0,2987,3741,7866,7066,10066,0,39726,0,8000,79.452
856,30000,2,2,2,25,-2,-2,-2,-2,-2,-2,26957,26269,17036,27497,16098,7300,1333,2256,27497,787,200,0,0,25624,24013,-10461,26710,15898,7300,121157,-12,32073,403.8566666666667
857,40000,2,1,2,29,0,0,2,2,2,2,26461,29425,30145,29361,33893,34487,3400,1500,0,5000,1300,0,1,23061,27925,30145,24361,32593,34487,183772,8,11200,459.42999999999995
858,100000,2,3,1,43,2,2,2,2,2,2,50485,51582,52141,52691,54199,53176,2200,2000,2000,2500,0,4500,1,48285,49582,50141,50191,54199,48676,314274,12,13200,314.274
859,130000,1,2,2,29,0,0,0,0,0,0,131041,133698,131990,127512,128683,129669,7000,5151,4464,5000,4702,8000,0,124041,128547,127526,122512,123981,121669,782593,0,34317,601.9946153846154
860,20000,2,2,2,27,0,0,0,0,0,0,20218,19194,20112,19712,19712,6321,1482,1400,0,0,0,0,0,18736,17794,20112,19712,19712,6321,105269,0,2882,526.345
861,50000,1,1,2,26,-2,-2,-2,-2,-2,-2,0,0,0,0,0,0,0,0,0,0,0,0,0,0,0,0,0,0,0,0,-12,0,0.0
862,260000,1,1,1,41,-2,-2,-1,0,0,0,1086,2853,38836,45087,47201,46199,3552,38836,20000,15000,15000,10000,0,-2466,-35983,18836,30087,32201,36199,181262,-5,102388,69.71615384615384
863,30000,2,3,2,52,2,2,7,7,7,7,2450,2450,2450,2450,2450,2450,0,0,0,0,0,0,1,2450,2450,2450,2450,2450,2450,14700,32,0,49.0
864,10000,2,2,1,31,0,0,0,0,0,0,15915,9050,9901,9975,9736,8703,2330,2200,1000,333,311,322,0,13585,6850,8901,9642,9425,8381,63280,0,6496,632.8000000000001
865,200000,1,1,2,32,0,0,0,0,0,0,43515,44557,45574,49022,47459,49666,1739,1756,2662,1726,3000,2500,0,41776,42801,42912,47296,44459,47166,279793,0,13383,139.8965
866,30000,2,2,1,46,0,0,0,0,0,0,28234,28874,29437,27738,27268,27409,1484,1436,1120,995,989,800,0,26750,27438,28317,26743,26279,26609,168960,0,6824,563.1999999999999
867,180000,2,2,2,35,0,0,0,-2,-2,-2,119333,123150,0,0,0,0,6000,0,0,0,0,0,0,113333,123150,0,0,0,0,242483,-6,6000,134.71277777777777
868,100000,1,1,2,35,0,0,-2,-2,-2,-2,29109,0,0,0,0,0,0,0,0,0,0,47970,0,29109,0,0,0,0,-47970,29109,-8,47970,29.109
869,140000,2,2,1,39,0,0,0,0,0,0,105192,90337,74510,73876,76180,78400,3000,6000,4000,4000,4000,3000,0,102192,84337,70510,69876,72180,75400,498495,0,24000,356.0678571428571
870,290000,2,2,2,34,0,0,0,0,0,0,310403,315048,314085,317631,315820,305498,12012,12012,11016,11088,12031,12031,0,298391,303036,303069,306543,303789,293467,1878485,0,70190,647.7534482758621
871,20000,2,2,3,52,0,0,0,0,0,0,14591,15616,16628,16958,17314,17664,1265,1277,607,629,638,641,0,13326,14339,16021,16329,16676,17023,98771,0,5057,493.855
872,80000,2,3,1,40,0,0,0,0,0,0,35660,37082,38464,38922,40791,43108,2000,2000,1397,2500,3000,1600,0,33660,35082,37067,36422,37791,41508,234027,0,12497,292.53375
873,500000,2,3,1,38,-2,-2,-2,-2,-2,-2,13655,8351,2340,2340,11435,189,8351,2340,2340,11435,189,5391,0,5304,6011,0,-9095,11246,-5202,38310,-12,30046,7.661999999999999
874,180000,1,1,1,45,-1,-1,-1,-1,-1,-1,4453,3310,7226,5060,2832,1890,3310,7228,5060,2832,1890,2576,0,1143,-3918,2166,2228,942,-686,24771,-6,22896,13.761666666666667
875,20000,2,3,1,40,-1,-1,-1,-1,-1,-1,2946,0,390,390,390,390,0,390,390,390,390,780,0,2946,-390,0,0,0,-390,4506,-6,2340,22.53
876,30000,2,2,1,25,0,0,0,0,0,2,30606,29579,30291,30616,30456,29818,1800,1512,1259,2500,0,1000,0,28806,28067,29032,28116,30456,28818,181366,2,8071,604.5533333333333
877,150000,1,1,2,33,0,0,0,0,0,0,45335,50262,54793,59244,64096,68837,6000,6000,6000,6000,6001,6000,0,39335,44262,48793,53244,58095,62837,342567,0,36001,228.37800000000001
878,280000,2,2,2,27,-1,-1,-1,-1,-1,-1,5924,5174,980,3058,3158,9530,5174,1078,3058,3158,9530,0,0,750,4096,-2078,-100,-6372,9530,27824,-6,21998,9.937142857142858
879,50000,2,2,1,43,0,0,0,-1,0,0,23587,24580,20165,10732,10566,10757,1800,1775,10732,384,757,501,0,21787,22805,9433,10348,9809,10256,100387,-1,15949,200.774
880,20000,2,2,1,43,2,0,0,0,0,2,15294,16340,17359,17776,19293,18844,1300,1300,700,1800,0,1000,0,13994,15040,16659,15976,19293,17844,104906,4,6100,524.53
881,200000,1,1,2,30,-1,-1,-1,0,0,0,4935,-200,11463,11751,11772,5318,0,11663,9363,3232,3000,1000,0,4935,-11863,2100,8519,8772,4318,45039,-3,28258,22.5195
882,210000,2,2,1,49,1,-2,-2,-2,-2,-2,0,0,0,0,0,0,0,0,0,0,0,0,1,0,0,0,0,0,0,0,-9,0,0.0
883,230000,2,1,2,38,0,0,0,0,0,0,224020,227311,184500,128190,130883,133504,8750,7470,4540,4710,4750,4900,0,215270,219841,179960,123480,126133,128604,1028408,0,35120,447.13391304347823
884,50000,1,3,2,57,0,0,0,0,0,0,47917,48455,48120,28450,29046,29647,1988,1989,1018,1054,1084,1048,0,45929,46466,47102,27396,27962,28599,231635,0,8181,463.27
885,50000,1,3,2,55,0,0,0,0,0,0,51737,27121,28103,28814,29261,29878,2930,1447,1158,1041,1082,994,1,48807,25674,26945,27773,28179,28884,194914,0,8652,389.82800000000003
886,70000,2,2,2,23,0,0,0,0,0,0,49605,51804,53041,55150,57098,59141,3000,2700,3000,3000,3000,4700,0,46605,49104,50041,52150,54098,54441,325839,0,19400,465.48428571428576
887,310000,1,1,2,30,-2,-2,-2,-2,-2,-2,1544,1648,1284,1088,892,-304,1300,1000,1000,1000,304,39544,0,244,648,284,88,588,-39848,6152,-12,44148,1.9845161290322582
888,180000,2,2,1,30,-1,-1,-1,-1,-1,-1,2488,13476,3173,13202,6594,2549,13476,3173,13212,6594,2549,1000,0,-10988,10303,-10039,6608,4045,1549,41482,-6,40004,23.045555555555556
889,90000,2,2,2,24,0,0,0,0,0,2,24401,22771,19461,16181,14669,14422,1454,1384,407,673,0,102,0,22947,21387,19054,15508,14669,14320,111905,2,4020,124.33888888888889
890,390000,1,2,2,28,0,0,0,0,0,0,149445,139794,133224,106127,51097,38555,8046,5150,5297,5084,5065,5042,0,141399,134644,127927,101043,46032,33513,618242,0,33684,158.52358974358975
891,150000,2,3,1,34,-1,-1,-1,-1,-1,-1,772,337,618,150,150,377,340,618,150,150,227,0,0,432,-281,468,0,-77,377,2404,-6,1485,1.602666666666667
892,400000,1,2,2,37,1,1,1,2,0,0,13611,15066,15882,12599,18599,12284,3019,5014,3,7040,2006,2005,0,10592,10052,15879,5559,16593,10279,88041,5,19087,22.01025
893,80000,2,2,1,32,0,0,0,0,0,-2,28408,25695,11553,2350,0,0,1259,1035,1600,0,0,0,0,27149,24660,9953,2350,0,0,68006,-2,3894,85.00750000000001
894,320000,1,1,2,27,0,0,0,0,0,0,137574,199563,122093,105425,100206,96073,6048,6371,3043,3031,3066,3031,0,131526,193192,119050,102394,97140,93042,760934,0,24590,237.791875
895,240000,2,2,1,37,-1,-1,-2,-2,-2,-2,238,0,0,0,0,0,0,0,0,0,0,0,1,238,0,0,0,0,0,238,-10,0,0.09916666666666668
896,200000,1,1,2,31,-2,-2,-2,-2,-2,-2,100,100,100,100,100,100,100,100,100,100,100,100,0,0,0,0,0,0,0,600,-12,600,0.3
897,110000,1,1,3,55,1,2,2,2,3,2,92610,94755,92351,101140,99260,101577,4500,0,11300,0,4100,0,1,88110,94755,81051,101140,95160,101577,581693,12,19900,528.8118181818181
898,170000,2,1,2,28,2,2,2,2,2,2,131864,133897,129761,138604,136283,145012,5600,0,11000,0,11000,5656,1,126264,133897,118761,138604,125283,139356,815421,12,33256,479.6594117647059
899,90000,2,3,3,51,0,0,0,0,2,0,11315,12340,13349,14276,13904,14184,1212,1221,1148,0,510,525,1,10103,11119,12201,14276,13394,13659,79368,2,4616,88.18666666666667
900,200000,1,1,1,36,-1,-1,0,-1,-1,-1,3877,11496,5935,295,1867,0,11496,1011,297,2923,0,0,0,-7619,10485,5638,-2628,1867,0,23470,-5,15727,11.735
901,360000,1,1,2,30,-2,-1,-1,-2,-2,-2,0,2500,0,0,0,0,2500,0,0,0,0,0,0,-2500,2500,0,0,0,0,2500,-10,2500,0.6944444444444444
902,140000,2,1,1,36,-1,-1,-2,-1,0,0,4036,0,0,2971,1607,0,0,0,2971,0,0,0,0,4036,0,-2971,2971,1607,0,8614,-5,2971,6.152857142857142
903,220000,1,2,2,25,0,0,0,0,0,0,168286,155893,119575,51317,51926,34608,10000,3900,1000,1000,2000,2000,0,158286,151993,118575,50317,49926,32608,581605,0,19900,264.3659090909091
904,100000,1,3,1,50,0,0,-2,-2,-2,-2,154970,0,0,0,0,0,0,0,0,0,0,0,0,154970,0,0,0,0,0,154970,-8,0,154.97
905,80000,2,2,2,40,2,0,0,0,2,2,57364,58637,59863,62860,63976,63293,2200,2200,4000,1777,0,2000,0,55164,56437,55863,61083,63976,61293,365993,6,12177,457.49125
906,30000,2,2,2,27,-1,-1,2,0,-1,2,27772,30461,29325,21449,29709,29086,3136,0,0,29709,0,1576,0,24636,30461,29325,-8260,29709,27510,167802,1,34421,559.34
907,50000,1,1,2,30,2,2,2,-1,2,2,4187,5152,3679,596,446,2699,2300,0,700,0,2300,0,1,1887,5152,2979,596,-1854,2699,16759,9,5300,33.518
908,120000,2,2,2,26,0,0,0,0,0,0,22431,12399,4199,3059,674,0,1500,1000,682,0,0,738,0,20931,11399,3517,3059,674,-738,42762,0,3920,35.635
909,50000,1,1,2,27,0,0,0,0,0,0,7010,9876,11115,12915,14415,0,3000,1500,2000,2000,0,0,0,4010,8376,9115,10915,14415,0,55331,0,8500,110.66199999999999
910,360000,2,1,2,27,0,-1,0,-1,-1,-1,79837,27456,68117,39105,54456,46153,27465,50154,39105,54456,46153,40000,0,52372,-22698,29012,-15351,8303,6153,315124,-4,257333,87.53444444444445
911,90000,2,1,2,25,2,2,2,2,0,0,86014,92898,92860,88533,90942,88813,8300,2400,1000,4000,3600,4000,0,77714,90498,91860,84533,87342,84813,540060,8,23300,600.0666666666666
912,500000,1,1,2,32,-1,0,0,0,0,0,386405,387910,293177,274539,253443,253671,25016,20018,10000,79377,52778,10000,0,361389,367892,283177,195162,200665,243671,1849145,-1,197189,369.829
913,140000,2,3,1,46,0,0,0,0,0,0,68075,69972,71805,73613,75426,77169,3000,3000,3000,3000,3000,5000,0,65075,66972,68805,70613,72426,72169,436060,0,20000,311.4714285714286
914,30000,1,3,1,45,0,0,2,0,0,0,17187,24045,23180,22000,22000,0,7900,0,0,0,0,0,0,9287,24045,23180,22000,22000,0,108412,2,7900,361.37333333333333
915,70000,1,3,1,30,0,0,0,0,0,0,19882,20611,21859,22445,22935,23404,1352,1600,949,1000,1000,1000,0,18530,19011,20910,21445,21935,22404,131136,0,6901,187.33714285714285
916,200000,1,1,1,39,-2,-2,-2,-2,-2,-2,0,0,0,0,0,3983,0,0,0,0,3983,0,0,0,0,0,0,-3983,3983,3983,-12,3983,1.9914999999999998
917,350000,1,1,1,48,0,0,0,0,0,0,54969,47978,48631,48351,47939,33827,2087,1989,1591,1466,2000,1500,0,52882,45989,47040,46885,45939,32327,281695,0,10633,80.48428571428572
918,120000,1,1,2,32,1,-2,-2,-2,-2,-2,0,0,0,0,0,0,0,0,0,0,0,0,1,0,0,0,0,0,0,0,-9,0,0.0
919,240000,1,1,2,46,0,0,0,0,0,0,471814,478380,395612,386295,356206,352257,16044,15087,12000,15000,12000,12000,0,455770,463293,383612,371295,344206,340257,2440564,0,82131,1016.9016666666666
920,90000,2,1,2,23,0,0,0,0,0,0,22109,25011,29230,32747,38217,43744,6000,5000,4000,6000,8000,4000,0,16109,20011,25230,26747,30217,39744,191058,0,33000,212.28666666666663
921,260000,2,1,2,33,1,-2,-2,-2,-1,-1,0,0,0,0,1980,2500,0,0,0,1980,2500,0,0,0,0,0,-1980,-520,2500,4480,-7,4480,1.723076923076923
922,50000,2,1,2,24,0,0,0,2,0,0,27245,28300,31900,31090,31837,32555,1800,4400,0,1400,1400,1400,0,25445,23900,31900,29690,30437,31155,182927,2,10400,365.854
923,110000,1,1,1,40,0,0,0,0,0,0,8481,13066,17638,22204,26784,31352,4980,5124,5256,5416,5552,5742,0,3501,7942,12382,16788,21232,25610,119525,0,32070,108.65909090909092
924,20000,2,1,2,24,-1,-1,2,-1,0,-1,1371,796,398,796,398,716,796,0,796,0,716,12111,0,575,796,-398,796,-318,-11395,4475,-2,14419,22.375
925,30000,2,2,2,24,0,0,0,0,0,0,27391,28412,28575,28925,24159,0,1767,1700,1010,1141,0,0,0,25624,26712,27565,27784,24159,0,137462,0,5618,458.2066666666667
926,180000,1,1,2,27,-2,-1,2,2,-2,-2,11392,14688,14040,13440,13440,13080,3500,0,0,0,0,0,1,7892,14688,14040,13440,13440,13080,80080,-3,3500,44.48888888888889
927,20000,1,2,1,46,0,0,0,0,0,0,5902,6767,8145,8153,8324,8490,1122,1500,291,302,304,319,0,4780,5267,7854,7851,8020,8171,45781,0,3838,228.905
928,50000,2,2,2,22,0,0,0,0,0,0,50342,50482,49217,40882,20258,20303,1896,1656,1750,717,753,1000,0,48446,48826,47467,40165,19505,19303,231484,0,7772,462.96799999999996
929,180000,2,1,2,36,-2,-2,-2,-2,-2,-2,10737,21197,11936,40420,9210,17795,21197,11936,40420,9210,17795,6915,0,-10460,9261,-28484,31210,-8585,10880,111295,-12,107473,61.830555555555556
930,200000,1,1,1,34,-2,-2,-2,-2,-2,-2,1242,4006,941,2357,2945,1143,4034,945,2366,2947,1143,744,0,-2792,3061,-1425,-590,1802,399,12634,-12,12179,6.317
931,260000,2,2,2,24,0,0,0,0,0,0,68411,60386,48663,50998,53835,56728,2500,4000,4000,3835,3805,3000,0,65911,56386,44663,47163,50030,53728,339021,0,21140,130.3926923076923
932,320000,1,1,1,60,-1,-1,-1,-1,0,-1,9955,3465,84421,886,11741,4317,3465,84440,886,11533,4317,52466,1,6490,-80975,83535,-10647,7424,-48149,114785,-5,157107,35.870312500000004
933,160000,2,2,2,29,2,2,-1,-1,-1,-1,1989,-8,866,0,892,0,0,874,0,892,0,594,1,1989,-882,866,-892,892,-594,3739,0,2360,2.336875
934,30000,1,2,2,32,2,0,0,2,2,2,7851,9065,11595,11112,12923,12566,1500,3000,0,2000,0,1000,1,6351,6065,11595,9112,12923,11566,65112,8,7500,217.04
935,50000,2,2,1,36,0,0,0,0,0,0,16906,17645,18478,10279,10646,10776,1314,1147,348,512,435,190,0,15592,16498,18130,9767,10211,10586,84730,0,3946,169.46
936,50000,1,2,2,30,0,0,0,0,-2,-2,21062,6495,2207,0,0,0,2000,1000,0,0,0,0,0,19062,5495,2207,0,0,0,29764,-4,3000,59.528000000000006
937,90000,2,2,2,29,0,0,0,0,0,0,47585,52084,53817,54818,55985,57398,10000,2600,2500,2200,2500,3000,0,37585,49484,51317,52618,53485,54398,321687,0,22800,357.43
938,240000,1,1,2,34,1,2,-1,-1,0,-1,11874,5979,6938,41858,10416,1711,0,6938,41877,0,1711,27162,0,11874,-959,-34939,41858,8705,-25451,78776,0,77688,32.82333333333333
939,180000,2,2,1,32,1,2,2,2,0,0,15548,15009,17752,17172,18732,23389,0,3000,0,2000,5000,2000,1,15548,12009,17752,15172,13732,21389,107602,7,12000,59.77888888888889
940,200000,2,2,1,32,-1,-1,-1,-1,-1,-1,5150,10190,10190,10190,10594,11193,10190,10190,10190,10594,11193,10190,0,-5040,0,0,-404,-599,1003,57507,-6,62547,28.7535
941,50000,2,1,2,25,0,0,0,0,0,2,42543,34629,27095,18538,20100,19630,1900,1428,600,3000,0,1000,0,40643,33201,26495,15538,20100,18630,162535,2,7928,325.07
942,50000,1,2,1,44,-1,-1,-1,-1,-1,-1,1261,1261,1261,1261,1261,1261,1261,1261,1261,1261,1261,1261,0,0,0,0,0,0,0,7566,-6,7566,15.132000000000001
943,330000,2,1,1,37,-1,-1,-1,-1,0,-1,4785,3403,0,5882,5882,1013,3523,0,5882,0,1013,0,0,1262,3403,-5882,5882,4869,1013,20965,-5,10418,6.3530303030303035
944,80000,2,2,2,24,2,2,5,5,4,3,1200,1200,1200,1200,600,300,0,0,0,0,0,0,1,1200,1200,1200,1200,600,300,5700,21,0,7.124999999999999
945,50000,2,2,2,23,-2,-2,-2,-2,-2,-2,3779,3944,2118,2259,3527,1100,3955,2124,2266,3638,1303,0,0,-176,1820,-148,-1379,2224,1100,16727,-12,13286,33.454
946,360000,2,1,2,29,0,0,-1,-1,-1,-1,15854,8174,1004,1004,646,3508,1000,1004,1004,646,3508,0,0,14854,7170,0,358,-2862,3508,30190,-4,7162,8.386111111111111
947,240000,2,2,1,37,0,0,0,0,0,0,219099,217058,187841,186140,191678,191816,8131,8123,6700,10000,7700,6000,0,210968,208935,181141,176140,183978,185816,1193632,0,46654,497.3466666666667
948,50000,1,2,1,59,0,0,0,0,0,0,47069,48479,49520,18990,19539,19791,2169,2210,680,855,726,687,0,44900,46269,48840,18135,18813,19104,203388,0,7327,406.77599999999995
949,470000,1,2,2,33,0,0,0,0,0,0,190258,181207,120318,129281,113437,164377,40012,10020,40069,25005,100000,51305,0,150246,171187,80249,104276,13437,113072,898878,0,266411,191.25063829787234
950,160000,2,3,1,51,-1,2,-1,-1,-1,-1,2000,1000,2125,2125,1000,2125,0,2125,2125,1000,2125,23250,0,2000,-1125,0,1125,-1125,-21125,10375,-3,30625,6.484375000000001
951,30000,1,1,1,27,-1,0,0,0,0,-2,12897,13484,6655,6618,0,0,2011,2211,2101,148,0,0,1,10886,11273,4554,6470,0,0,39654,-3,6471,132.18
952,80000,2,2,1,32,0,0,0,0,0,0,81074,78262,76163,76813,77511,79069,3700,3400,2900,2900,2841,3100,0,77374,74862,73263,73913,74670,75969,468892,0,18841,586.115
953,500000,2,3,2,42,-2,-1,-1,0,0,0,10889,26146,104279,103945,101945,90193,29987,104279,2085,1130,45551,0,0,-19098,-78133,102194,102815,56394,90193,437397,-4,183032,87.4794
954,180000,1,2,2,39,-1,-1,-1,-1,-1,0,3135,2822,1938,5818,2628,2628,2833,2015,5818,2628,0,0,0,302,807,-3880,3190,2628,2628,18969,-5,13294,10.538333333333332
955,110000,2,2,1,46,-1,-1,-1,-1,-1,0,2410,2151,2161,1719,107591,107940,2151,2161,1719,107591,5000,3500,0,259,-10,442,-105872,102591,104440,223972,-5,122122,203.6109090909091
956,160000,1,1,1,41,0,-1,0,0,2,2,117126,11222,15513,18087,17499,19939,15315,15000,3000,0,3000,0,0,101811,-3778,12513,18087,14499,19939,199386,3,36315,124.61625000000001
957,210000,2,2,2,30,0,0,0,0,0,0,21780,20974,18652,13464,109722,105573,1325,1074,1000,99000,3745,4000,0,20455,19900,17652,-85536,105977,101573,290165,0,110144,138.17380952380952
958,200000,2,1,1,34,-1,0,0,-1,0,-1,6206,6723,7545,362,181,488,1120,1024,362,0,488,300,1,5086,5699,7183,362,-307,188,21505,-3,3294,10.7525
959,350000,1,1,2,35,-1,-1,-1,0,0,0,4439,33720,14283,16426,10833,2261,33891,16267,4027,234,1565,26346,0,-29452,17453,10256,16192,9268,-24085,81962,-3,82330,23.417714285714286
960,250000,1,1,2,41,-1,-1,-1,0,-1,-1,1338,-24,8324,5872,23020,2367,0,8348,0,23020,2367,3117,1,1338,-8372,8324,-17148,20653,-750,40897,-5,36852,16.358800000000002
961,380000,1,1,2,43,1,2,2,-2,-2,-2,8201,7882,-2,-2,-2,-2,39,0,0,0,0,0,1,8162,7882,-2,-2,-2,-2,16075,-1,39,4.230263157894737
962,30000,1,2,2,47,-1,-1,-1,-1,0,-1,396,396,396,792,396,772,396,396,792,0,772,0,0,0,0,-396,792,-376,772,3148,-5,2356,10.493333333333334
963,200000,1,2,2,31,0,0,0,0,0,0,33781,35879,26043,27497,29082,31647,3000,2000,2000,2000,3000,4000,0,30781,33879,24043,25497,26082,27647,183929,0,16000,91.9645
964,30000,1,2,2,30,-1,0,0,0,0,0,27826,28672,29622,30271,24536,22913,1600,1500,1000,1000,1000,1000,0,26226,27172,28622,29271,23536,21913,163840,-1,7100,546.1333333333333
965,50000,1,2,2,24,0,0,-1,-1,0,0,14937,12171,3847,11117,6479,6187,3027,3858,11139,3009,3016,3008,0,11910,8313,-7292,8108,3463,3179,54738,-2,27057,109.476
966,500000,1,1,1,36,0,0,0,0,0,0,294827,292920,291760,288024,274632,266669,20007,20026,20020,10017,15024,10002,0,274820,272894,271740,278007,259608,256667,1708832,0,95096,341.7664
967,30000,1,1,2,28,1,-2,-1,-1,-1,-2,0,0,1310,816,0,0,0,1310,816,0,0,0,0,0,-1310,494,816,0,0,2126,-6,2126,7.086666666666666
968,220000,2,1,1,36,-1,-1,0,-1,-1,-1,996,4102,4111,1057,990,1324,4102,1111,1057,990,1324,1039,0,-3106,2991,3054,67,-334,285,12580,-5,9623,5.718181818181818
969,20000,2,2,1,27,0,0,0,-1,0,0,42784,41009,44267,47149,48497,14774,3000,5000,10000,3011,2011,2011,0,39784,36009,34267,44138,46486,12763,238480,-1,25033,1192.3999999999999
970,180000,2,2,1,32,0,0,0,0,-1,-1,74189,30670,6428,4618,2708,54024,2000,1000,0,2708,54024,2000,0,72189,29670,6428,1910,-51316,52024,172637,-2,61732,95.90944444444445
971,300000,1,1,1,42,-1,0,0,-1,0,0,11973,61834,25145,37666,19453,10492,20979,5000,37676,8808,2000,2709,1,-9006,56834,-12531,28858,17453,7783,166563,-2,77172,55.521
972,130000,2,2,1,33,0,0,0,0,0,0,133461,133393,132211,101807,101083,101597,7010,6657,3899,3952,3900,4000,0,126451,126736,128312,97855,97183,97597,703552,0,29418,541.1938461538462
973,180000,2,3,1,39,2,2,2,2,2,0,10159,12689,12183,13979,13621,14809,2710,0,2000,0,2000,2000,1,7449,12689,10183,13979,11621,12809,77440,10,8710,43.022222222222226
974,150000,2,1,3,30,-2,-2,-2,-2,-2,-2,50,6527,2168,-7,1373,-1,8589,2500,0,1380,0,2050,0,-8539,4027,2168,-1387,1373,-2051,10110,-12,14519,6.74
975,140000,1,2,1,30,0,0,0,0,0,0,134203,127319,107496,69218,70702,72267,5000,3500,2700,2600,2742,2700,1,129203,123819,104796,66618,67960,69567,581205,0,19242,415.1464285714286
976,50000,2,2,2,22,0,0,0,0,0,0,49609,61162,31485,15281,18031,18233,2100,2000,4000,3000,1500,1000,0,47509,59162,27485,12281,16531,17233,193801,0,13600,387.602
977,20000,1,2,2,25,1,2,2,0,0,0,6174,7543,7255,3887,5887,0,2000,28,0,2000,0,0,1,4174,7515,7255,1887,5887,0,30746,5,4028,153.73000000000002
978,180000,1,1,2,28,-1,-1,-1,-1,-1,-1,666,662,-4,55566,1056,390,662,0,61411,1056,0,1998,0,4,662,-61415,54510,1056,-1608,58336,-6,65127,32.40888888888889
979,180000,1,2,2,26,0,0,0,0,0,0,5591,6619,10574,7733,6794,5487,1126,4081,240,504,169,62,1,4465,2538,10334,7229,6625,5425,42798,0,6182,23.776666666666664
980,150000,2,3,1,54,-1,0,0,0,2,0,148747,145231,145341,153833,151194,145738,5500,5500,11000,0,6000,5215,0,143247,139731,134341,153833,145194,140523,890084,1,33215,593.3893333333334
981,70000,2,1,2,24,0,0,0,0,0,0,63903,65248,62958,64209,59482,60883,3000,2190,2201,2181,2413,1952,0,60903,63058,60757,62028,57069,58931,376683,0,13937,538.1185714285715
982,30000,1,2,2,29,8,7,6,5,4,3,34423,33952,33165,32391,31332,30558,0,0,0,0,0,0,0,34423,33952,33165,32391,31332,30558,195821,33,0,652.7366666666667
983,500000,1,1,2,36,-2,-2,-2,-2,-2,-2,45106,81264,18122,27229,21462,27911,81690,18225,27365,21570,28050,17397,1,-36584,63039,-9243,5659,-6588,10514,221094,-12,194297,44.2188
984,60000,1,3,1,49,0,0,0,0,0,0,44801,41545,40649,40843,40612,40656,3000,4506,2500,1800,4200,2500,0,41801,37039,38149,39043,36412,38156,249106,0,18506,415.17666666666673
985,50000,2,1,2,23,-2,-2,-2,-2,-2,-2,49860,50187,50022,20114,18777,18273,2500,1289,917,1315,5042,2512,0,47360,48898,49105,18799,13735,15761,207233,-12,13575,414.466
986,130000,1,3,2,43,1,-1,-1,-2,-1,-1,1018,6377,-2,935,4985,1212,6433,2,937,4990,1215,9546,1,-5415,6375,-939,-4055,3770,-8334,14525,-5,23123,11.173076923076923
987,260000,2,2,1,33,-2,-2,-2,-1,-1,0,134736,135593,120909,102524,40157,40805,6067,10000,3000,40157,1466,2000,0,128669,125593,117909,62367,38691,38805,574724,-8,62690,221.04769230769233
988,380000,1,3,1,53,-2,-2,-2,-2,-2,-2,0,0,0,0,0,0,0,0,0,0,0,0,0,0,0,0,0,0,0,0,-12,0,0.0
989,360000,2,2,2,25,2,2,2,2,2,2,286732,290690,284059,294308,297916,279503,10792,0,15000,5800,0,126685,0,275940,290690,269059,288508,297916,152818,1733208,12,158277,481.4466666666666
990,50000,1,3,1,54,1,2,2,0,0,0,62847,60885,56828,55419,54054,53143,2100,0,2000,2000,2455,4000,0,60747,60885,54828,53419,51599,49143,343176,5,12555,686.352
991,50000,2,3,1,39,0,0,2,-1,0,0,58300,59727,142,29886,30510,31276,7876,161,74354,927,1089,9100,0,50424,59566,-74212,28959,29421,22176,209841,1,93507,419.68199999999996
992,260000,2,1,1,44,-1,2,2,-1,-1,-2,1215,856,291,803,98,431,0,291,803,98,431,1104,1,1215,565,-512,705,-333,-673,3694,-1,2727,1.4207692307692308
993,80000,2,2,2,27,0,0,0,0,0,0,57376,58649,59873,61077,62394,63655,2200,2200,2200,2300,2300,2600,0,55176,56449,57673,58777,60094,61055,363024,0,13800,453.78
994,360000,2,1,2,25,0,0,0,0,0,-2,279846,169426,68810,12800,0,0,7004,1793,2757,0,0,0,1,272842,167633,66053,12800,0,0,530882,-2,11554,147.4672222222222
995,290000,2,1,2,29,1,-2,-2,-2,-2,-2,0,0,0,0,0,0,0,0,0,0,0,0,1,0,0,0,0,0,0,0,-9,0,0.0
996,200000,1,1,2,39,-2,-2,-2,-2,-2,-2,-200,-200,-200,0,60800,0,0,0,200,60800,0,0,0,-200,-200,-400,-60800,60800,0,60200,-12,61000,30.099999999999998
997,140000,1,1,1,45,0,0,0,0,2,2,39716,40799,41853,44452,45433,46383,1600,1600,3169,1700,1700,1495,0,38116,39199,38684,42752,43733,44888,258636,4,11264,184.73999999999998
998,360000,1,1,1,38,1,-2,-2,-2,-2,-2,0,0,0,0,0,0,0,0,0,0,0,0,1,0,0,0,0,0,0,0,-9,0,0.0
999,50000,2,2,2,23,-1,-1,-1,0,-1,-1,780,0,780,390,390,500,0,780,0,390,500,18300,1,780,-780,780,0,-110,-17800,2840,-5,19970,5.680000000000001
1000,120000,1,2,2,25,2,2,0,0,0,0,113348,110119,111700,83858,86434,88802,0,5000,3158,3934,3802,2000,0,113348,105119,108542,79924,82632,86802,594261,4,17894,495.21750000000003
